<org.springframework.boot.loader.nio.file.NestedFileStore: void <init>(org.springframework.boot.loader.nio.file.NestedFileSystem)>/@this	org.springframework.boot.loader.nio.file.NestedFileStore
<org.springframework.boot.loader.nio.file.NestedFileStore: void <init>(org.springframework.boot.loader.nio.file.NestedFileSystem)>/@parameter0	org.springframework.boot.loader.nio.file.NestedFileSystem
<org.springframework.boot.loader.zip.Zip64EndOfCentralDirectoryRecord: void <init>(long,long,short,short,int,int,long,long,long,long)>/@this	org.springframework.boot.loader.zip.Zip64EndOfCentralDirectoryRecord
<org.springframework.boot.loader.zip.Zip64EndOfCentralDirectoryRecord: void <init>(long,long,short,short,int,int,long,long,long,long)>/@parameter0	long
<org.springframework.boot.loader.zip.Zip64EndOfCentralDirectoryRecord: void <init>(long,long,short,short,int,int,long,long,long,long)>/@parameter1	long
<org.springframework.boot.loader.zip.Zip64EndOfCentralDirectoryRecord: void <init>(long,long,short,short,int,int,long,long,long,long)>/@parameter2	short
<org.springframework.boot.loader.zip.Zip64EndOfCentralDirectoryRecord: void <init>(long,long,short,short,int,int,long,long,long,long)>/@parameter3	short
<org.springframework.boot.loader.zip.Zip64EndOfCentralDirectoryRecord: void <init>(long,long,short,short,int,int,long,long,long,long)>/@parameter4	int
<org.springframework.boot.loader.zip.Zip64EndOfCentralDirectoryRecord: void <init>(long,long,short,short,int,int,long,long,long,long)>/@parameter5	int
<org.springframework.boot.loader.zip.Zip64EndOfCentralDirectoryRecord: void <init>(long,long,short,short,int,int,long,long,long,long)>/@parameter6	long
<org.springframework.boot.loader.zip.Zip64EndOfCentralDirectoryRecord: void <init>(long,long,short,short,int,int,long,long,long,long)>/@parameter7	long
<org.springframework.boot.loader.zip.Zip64EndOfCentralDirectoryRecord: void <init>(long,long,short,short,int,int,long,long,long,long)>/@parameter8	long
<org.springframework.boot.loader.zip.Zip64EndOfCentralDirectoryRecord: void <init>(long,long,short,short,int,int,long,long,long,long)>/@parameter9	long
<org.springframework.boot.loader.nio.file.NestedFileStore: void <init>(org.springframework.boot.loader.nio.file.NestedFileSystem)>/this#_0	org.springframework.boot.loader.nio.file.NestedFileStore
<org.springframework.boot.loader.zip.Zip64EndOfCentralDirectoryRecord: void <init>(long,long,short,short,int,int,long,long,long,long)>/this#_0	org.springframework.boot.loader.zip.Zip64EndOfCentralDirectoryRecord
<org.springframework.boot.loader.nio.file.NestedFileStore: void <init>(org.springframework.boot.loader.nio.file.NestedFileSystem)>/fileSystem#_0	org.springframework.boot.loader.nio.file.NestedFileSystem
<org.springframework.boot.loader.zip.Zip64EndOfCentralDirectoryRecord: void <init>(long,long,short,short,int,int,long,long,long,long)>/size#_0	long
<org.springframework.boot.loader.zip.Zip64EndOfCentralDirectoryRecord: void <init>(long,long,short,short,int,int,long,long,long,long)>/sizeOfZip64EndOfCentralDirectoryRecord#_0	long
<org.springframework.boot.loader.zip.Zip64EndOfCentralDirectoryRecord: void <init>(long,long,short,short,int,int,long,long,long,long)>/versionMadeBy#_0	short
<org.springframework.boot.loader.zip.Zip64EndOfCentralDirectoryRecord: void <init>(long,long,short,short,int,int,long,long,long,long)>/versionNeededToExtract#_0	short
<org.springframework.boot.loader.zip.Zip64EndOfCentralDirectoryRecord: void <init>(long,long,short,short,int,int,long,long,long,long)>/numberOfThisDisk#_0	int
<org.springframework.boot.loader.zip.Zip64EndOfCentralDirectoryRecord: void <init>(long,long,short,short,int,int,long,long,long,long)>/diskWhereCentralDirectoryStarts#_0	int
<org.springframework.boot.loader.zip.Zip64EndOfCentralDirectoryRecord: void <init>(long,long,short,short,int,int,long,long,long,long)>/numberOfCentralDirectoryEntriesOnThisDisk#_0	long
<org.springframework.boot.loader.zip.Zip64EndOfCentralDirectoryRecord: void <init>(long,long,short,short,int,int,long,long,long,long)>/totalNumberOfCentralDirectoryEntries#_0	long
<org.springframework.boot.loader.zip.Zip64EndOfCentralDirectoryRecord: void <init>(long,long,short,short,int,int,long,long,long,long)>/sizeOfCentralDirectory#_0	long
<org.springframework.boot.loader.zip.Zip64EndOfCentralDirectoryRecord: void <init>(long,long,short,short,int,int,long,long,long,long)>/offsetToStartOfCentralDirectory#_0	long
<org.springframework.boot.loader.nio.file.NestedFileStore: java.lang.String name()>/@this	org.springframework.boot.loader.nio.file.NestedFileStore
<org.springframework.boot.loader.nio.file.NestedFileStore: java.lang.String name()>/this#_0	org.springframework.boot.loader.nio.file.NestedFileStore
<org.springframework.boot.loader.nio.file.NestedFileStore: java.lang.String name()>/$stack1	org.springframework.boot.loader.nio.file.NestedFileSystem
<org.springframework.boot.loader.nio.file.NestedFileStore: java.lang.String name()>/$stack2	java.lang.String
<org.springframework.boot.loader.zip.Zip64EndOfCentralDirectoryRecord: org.springframework.boot.loader.zip.Zip64EndOfCentralDirectoryRecord load(org.springframework.boot.loader.zip.DataBlock,org.springframework.boot.loader.zip.Zip64EndOfCentralDirectoryLocator)>/@parameter0	org.springframework.boot.loader.zip.DataBlock
<org.springframework.boot.loader.zip.Zip64EndOfCentralDirectoryRecord: org.springframework.boot.loader.zip.Zip64EndOfCentralDirectoryRecord load(org.springframework.boot.loader.zip.DataBlock,org.springframework.boot.loader.zip.Zip64EndOfCentralDirectoryLocator)>/@parameter1	org.springframework.boot.loader.zip.Zip64EndOfCentralDirectoryLocator
<org.springframework.boot.loader.nio.file.NestedFileStore: java.lang.String type()>/@this	org.springframework.boot.loader.nio.file.NestedFileStore
<org.springframework.boot.loader.nio.file.NestedFileStore: java.lang.String type()>/this#_0	org.springframework.boot.loader.nio.file.NestedFileStore
<org.springframework.boot.loader.nio.file.NestedFileStore: java.lang.String type()>/$stringconstant0	java.lang.String
<org.springframework.boot.loader.zip.Zip64EndOfCentralDirectoryRecord: org.springframework.boot.loader.zip.Zip64EndOfCentralDirectoryRecord load(org.springframework.boot.loader.zip.DataBlock,org.springframework.boot.loader.zip.Zip64EndOfCentralDirectoryLocator)>/locator#_0	org.springframework.boot.loader.zip.Zip64EndOfCentralDirectoryLocator
<org.springframework.boot.loader.zip.Zip64EndOfCentralDirectoryRecord: org.springframework.boot.loader.zip.Zip64EndOfCentralDirectoryRecord load(org.springframework.boot.loader.zip.DataBlock,org.springframework.boot.loader.zip.Zip64EndOfCentralDirectoryLocator)>/buffer#_71	java.nio.ByteBuffer
<org.springframework.boot.loader.zip.Zip64EndOfCentralDirectoryRecord: org.springframework.boot.loader.zip.Zip64EndOfCentralDirectoryRecord load(org.springframework.boot.loader.zip.DataBlock,org.springframework.boot.loader.zip.Zip64EndOfCentralDirectoryLocator)>/$stack8	java.nio.ByteOrder
<org.springframework.boot.loader.zip.Zip64EndOfCentralDirectoryRecord: org.springframework.boot.loader.zip.Zip64EndOfCentralDirectoryRecord load(org.springframework.boot.loader.zip.DataBlock,org.springframework.boot.loader.zip.Zip64EndOfCentralDirectoryLocator)>/$stack10	long
<org.springframework.boot.loader.zip.Zip64EndOfCentralDirectoryRecord: org.springframework.boot.loader.zip.Zip64EndOfCentralDirectoryRecord load(org.springframework.boot.loader.zip.DataBlock,org.springframework.boot.loader.zip.Zip64EndOfCentralDirectoryLocator)>/$stack11	long
<org.springframework.boot.loader.zip.Zip64EndOfCentralDirectoryRecord: org.springframework.boot.loader.zip.Zip64EndOfCentralDirectoryRecord load(org.springframework.boot.loader.zip.DataBlock,org.springframework.boot.loader.zip.Zip64EndOfCentralDirectoryLocator)>/size#_73	long
<org.springframework.boot.loader.zip.Zip64EndOfCentralDirectoryRecord: org.springframework.boot.loader.zip.Zip64EndOfCentralDirectoryRecord load(org.springframework.boot.loader.zip.DataBlock,org.springframework.boot.loader.zip.Zip64EndOfCentralDirectoryLocator)>/$stack12	long
<org.springframework.boot.loader.zip.Zip64EndOfCentralDirectoryRecord: org.springframework.boot.loader.zip.Zip64EndOfCentralDirectoryRecord load(org.springframework.boot.loader.zip.DataBlock,org.springframework.boot.loader.zip.Zip64EndOfCentralDirectoryLocator)>/pos#_74	long
<org.springframework.boot.loader.zip.Zip64EndOfCentralDirectoryRecord: org.springframework.boot.loader.zip.Zip64EndOfCentralDirectoryRecord load(org.springframework.boot.loader.zip.DataBlock,org.springframework.boot.loader.zip.Zip64EndOfCentralDirectoryLocator)>/$stack13	org.springframework.boot.loader.log.DebugLogger
<org.springframework.boot.loader.zip.Zip64EndOfCentralDirectoryRecord: org.springframework.boot.loader.zip.Zip64EndOfCentralDirectoryRecord load(org.springframework.boot.loader.zip.DataBlock,org.springframework.boot.loader.zip.Zip64EndOfCentralDirectoryLocator)>/$stack14	java.lang.Long
<org.springframework.boot.loader.zip.Zip64EndOfCentralDirectoryRecord: org.springframework.boot.loader.zip.Zip64EndOfCentralDirectoryRecord load(org.springframework.boot.loader.zip.DataBlock,org.springframework.boot.loader.zip.Zip64EndOfCentralDirectoryLocator)>/$stack15	java.lang.Long
<org.springframework.boot.loader.zip.Zip64EndOfCentralDirectoryRecord: org.springframework.boot.loader.zip.Zip64EndOfCentralDirectoryRecord load(org.springframework.boot.loader.zip.DataBlock,org.springframework.boot.loader.zip.Zip64EndOfCentralDirectoryLocator)>/dataBlock#_0	org.springframework.boot.loader.zip.DataBlock
<org.springframework.boot.loader.zip.Zip64EndOfCentralDirectoryRecord: org.springframework.boot.loader.zip.Zip64EndOfCentralDirectoryRecord load(org.springframework.boot.loader.zip.DataBlock,org.springframework.boot.loader.zip.Zip64EndOfCentralDirectoryLocator)>/signature#_78	int
<org.springframework.boot.loader.zip.Zip64EndOfCentralDirectoryRecord: org.springframework.boot.loader.zip.Zip64EndOfCentralDirectoryRecord load(org.springframework.boot.loader.zip.DataBlock,org.springframework.boot.loader.zip.Zip64EndOfCentralDirectoryLocator)>/$stack17	org.springframework.boot.loader.zip.Zip64EndOfCentralDirectoryRecord
<org.springframework.boot.loader.zip.Zip64EndOfCentralDirectoryRecord: org.springframework.boot.loader.zip.Zip64EndOfCentralDirectoryRecord load(org.springframework.boot.loader.zip.DataBlock,org.springframework.boot.loader.zip.Zip64EndOfCentralDirectoryLocator)>/$stack18	long
<org.springframework.boot.loader.zip.Zip64EndOfCentralDirectoryRecord: org.springframework.boot.loader.zip.Zip64EndOfCentralDirectoryRecord load(org.springframework.boot.loader.zip.DataBlock,org.springframework.boot.loader.zip.Zip64EndOfCentralDirectoryLocator)>/$stack19	long
<org.springframework.boot.loader.zip.Zip64EndOfCentralDirectoryRecord: org.springframework.boot.loader.zip.Zip64EndOfCentralDirectoryRecord load(org.springframework.boot.loader.zip.DataBlock,org.springframework.boot.loader.zip.Zip64EndOfCentralDirectoryLocator)>/$stack20	long
<org.springframework.boot.loader.zip.Zip64EndOfCentralDirectoryRecord: org.springframework.boot.loader.zip.Zip64EndOfCentralDirectoryRecord load(org.springframework.boot.loader.zip.DataBlock,org.springframework.boot.loader.zip.Zip64EndOfCentralDirectoryLocator)>/$stack21	long
<org.springframework.boot.loader.zip.Zip64EndOfCentralDirectoryRecord: org.springframework.boot.loader.zip.Zip64EndOfCentralDirectoryRecord load(org.springframework.boot.loader.zip.DataBlock,org.springframework.boot.loader.zip.Zip64EndOfCentralDirectoryLocator)>/$stack22	int
<org.springframework.boot.loader.zip.Zip64EndOfCentralDirectoryRecord: org.springframework.boot.loader.zip.Zip64EndOfCentralDirectoryRecord load(org.springframework.boot.loader.zip.DataBlock,org.springframework.boot.loader.zip.Zip64EndOfCentralDirectoryLocator)>/$stack23	int
<org.springframework.boot.loader.zip.Zip64EndOfCentralDirectoryRecord: org.springframework.boot.loader.zip.Zip64EndOfCentralDirectoryRecord load(org.springframework.boot.loader.zip.DataBlock,org.springframework.boot.loader.zip.Zip64EndOfCentralDirectoryLocator)>/$stack24	short
<org.springframework.boot.loader.zip.Zip64EndOfCentralDirectoryRecord: org.springframework.boot.loader.zip.Zip64EndOfCentralDirectoryRecord load(org.springframework.boot.loader.zip.DataBlock,org.springframework.boot.loader.zip.Zip64EndOfCentralDirectoryLocator)>/$stack25	short
<org.springframework.boot.loader.zip.Zip64EndOfCentralDirectoryRecord: org.springframework.boot.loader.zip.Zip64EndOfCentralDirectoryRecord load(org.springframework.boot.loader.zip.DataBlock,org.springframework.boot.loader.zip.Zip64EndOfCentralDirectoryLocator)>/$stack26	long
<org.springframework.boot.loader.zip.Zip64EndOfCentralDirectoryRecord: org.springframework.boot.loader.zip.Zip64EndOfCentralDirectoryRecord load(org.springframework.boot.loader.zip.DataBlock,org.springframework.boot.loader.zip.Zip64EndOfCentralDirectoryLocator)>/$stack27	org.springframework.boot.loader.log.DebugLogger
<org.springframework.boot.loader.zip.Zip64EndOfCentralDirectoryRecord: org.springframework.boot.loader.zip.Zip64EndOfCentralDirectoryRecord load(org.springframework.boot.loader.zip.DataBlock,org.springframework.boot.loader.zip.Zip64EndOfCentralDirectoryLocator)>/$stack28	java.lang.Long
<org.springframework.boot.loader.zip.Zip64EndOfCentralDirectoryRecord: org.springframework.boot.loader.zip.Zip64EndOfCentralDirectoryRecord load(org.springframework.boot.loader.zip.DataBlock,org.springframework.boot.loader.zip.Zip64EndOfCentralDirectoryLocator)>/$stack29	java.lang.Integer
<org.springframework.boot.loader.zip.Zip64EndOfCentralDirectoryRecord: org.springframework.boot.loader.zip.Zip64EndOfCentralDirectoryRecord load(org.springframework.boot.loader.zip.DataBlock,org.springframework.boot.loader.zip.Zip64EndOfCentralDirectoryLocator)>/$stack30	java.io.IOException
<org.springframework.boot.loader.zip.Zip64EndOfCentralDirectoryRecord: org.springframework.boot.loader.zip.Zip64EndOfCentralDirectoryRecord load(org.springframework.boot.loader.zip.DataBlock,org.springframework.boot.loader.zip.Zip64EndOfCentralDirectoryLocator)>/$stack31	java.lang.String
<org.springframework.boot.loader.zip.Zip64EndOfCentralDirectoryRecord: org.springframework.boot.loader.zip.Zip64EndOfCentralDirectoryRecord load(org.springframework.boot.loader.zip.DataBlock,org.springframework.boot.loader.zip.Zip64EndOfCentralDirectoryLocator)>/$null0	org.springframework.boot.loader.zip.Zip64EndOfCentralDirectoryRecord
<org.springframework.boot.loader.nio.file.NestedFileStore: boolean isReadOnly()>/@this	org.springframework.boot.loader.nio.file.NestedFileStore
<org.springframework.boot.loader.zip.Zip64EndOfCentralDirectoryRecord: org.springframework.boot.loader.zip.Zip64EndOfCentralDirectoryRecord load(org.springframework.boot.loader.zip.DataBlock,org.springframework.boot.loader.zip.Zip64EndOfCentralDirectoryLocator)>/$numconstant0	int
<org.springframework.boot.loader.nio.file.NestedFileStore: boolean isReadOnly()>/this#_0	org.springframework.boot.loader.nio.file.NestedFileStore
<org.springframework.boot.loader.nio.file.NestedFileStore: boolean isReadOnly()>/$stack1	org.springframework.boot.loader.nio.file.NestedFileSystem
<org.springframework.boot.loader.nio.file.NestedFileStore: boolean isReadOnly()>/$stack2	boolean
<org.springframework.boot.loader.nio.file.NestedFileStore: long getTotalSpace()>/@this	org.springframework.boot.loader.nio.file.NestedFileStore
<org.springframework.boot.loader.nio.file.NestedFileStore: long getTotalSpace()>/this#_0	org.springframework.boot.loader.nio.file.NestedFileStore
<org.springframework.boot.loader.nio.file.NestedFileStore: long getTotalSpace()>/$numconstant0	long
<org.springframework.boot.loader.nio.file.NestedFileStore: long getUsableSpace()>/@this	org.springframework.boot.loader.nio.file.NestedFileStore
<org.springframework.boot.loader.nio.file.NestedFileStore: long getUsableSpace()>/this#_0	org.springframework.boot.loader.nio.file.NestedFileStore
<org.springframework.boot.loader.nio.file.NestedFileStore: long getUsableSpace()>/$numconstant0	long
<org.springframework.boot.loader.nio.file.NestedFileStore: long getUnallocatedSpace()>/@this	org.springframework.boot.loader.nio.file.NestedFileStore
<org.springframework.boot.loader.zip.Zip64EndOfCentralDirectoryRecord: org.springframework.boot.loader.zip.Zip64EndOfCentralDirectoryRecord load(org.springframework.boot.loader.zip.DataBlock,org.springframework.boot.loader.zip.Zip64EndOfCentralDirectoryLocator)>/$stringconstant0	java.lang.String
<org.springframework.boot.loader.nio.file.NestedFileStore: long getUnallocatedSpace()>/this#_0	org.springframework.boot.loader.nio.file.NestedFileStore
<org.springframework.boot.loader.nio.file.NestedFileStore: long getUnallocatedSpace()>/$numconstant0	long
<org.springframework.boot.loader.nio.file.NestedFileStore: boolean supportsFileAttributeView(java.lang.Class)>/@this	org.springframework.boot.loader.nio.file.NestedFileStore
<org.springframework.boot.loader.nio.file.NestedFileStore: boolean supportsFileAttributeView(java.lang.Class)>/@parameter0	java.lang.Class
<org.springframework.boot.loader.zip.Zip64EndOfCentralDirectoryRecord: org.springframework.boot.loader.zip.Zip64EndOfCentralDirectoryRecord load(org.springframework.boot.loader.zip.DataBlock,org.springframework.boot.loader.zip.Zip64EndOfCentralDirectoryLocator)>/$stringconstant1	java.lang.String
<org.springframework.boot.loader.nio.file.NestedFileStore: boolean supportsFileAttributeView(java.lang.Class)>/this#_0	org.springframework.boot.loader.nio.file.NestedFileStore
<org.springframework.boot.loader.nio.file.NestedFileStore: boolean supportsFileAttributeView(java.lang.Class)>/type#_0	java.lang.Class
<org.springframework.boot.loader.nio.file.NestedFileStore: boolean supportsFileAttributeView(java.lang.Class)>/$stack2	java.nio.file.FileStore
<org.springframework.boot.loader.nio.file.NestedFileStore: boolean supportsFileAttributeView(java.lang.Class)>/$stack3	boolean
<org.springframework.boot.loader.nio.file.NestedFileStore: boolean supportsFileAttributeView(java.lang.String)>/@this	org.springframework.boot.loader.nio.file.NestedFileStore
<org.springframework.boot.loader.nio.file.NestedFileStore: boolean supportsFileAttributeView(java.lang.String)>/@parameter0	java.lang.String
<org.springframework.boot.loader.zip.Zip64EndOfCentralDirectoryRecord: org.springframework.boot.loader.zip.Zip64EndOfCentralDirectoryRecord load(org.springframework.boot.loader.zip.DataBlock,org.springframework.boot.loader.zip.Zip64EndOfCentralDirectoryLocator)>/$stringconstant2	java.lang.String
<org.springframework.boot.loader.nio.file.NestedFileStore: boolean supportsFileAttributeView(java.lang.String)>/this#_0	org.springframework.boot.loader.nio.file.NestedFileStore
<org.springframework.boot.loader.nio.file.NestedFileStore: boolean supportsFileAttributeView(java.lang.String)>/name#_0	java.lang.String
<org.springframework.boot.loader.nio.file.NestedFileStore: boolean supportsFileAttributeView(java.lang.String)>/$stack2	java.nio.file.FileStore
<org.springframework.boot.loader.nio.file.NestedFileStore: boolean supportsFileAttributeView(java.lang.String)>/$stack3	boolean
<org.springframework.boot.loader.nio.file.NestedFileStore: java.nio.file.attribute.FileStoreAttributeView getFileStoreAttributeView(java.lang.Class)>/@this	org.springframework.boot.loader.nio.file.NestedFileStore
<org.springframework.boot.loader.nio.file.NestedFileStore: java.nio.file.attribute.FileStoreAttributeView getFileStoreAttributeView(java.lang.Class)>/@parameter0	java.lang.Class
<org.springframework.boot.loader.nio.file.NestedFileStore: java.nio.file.attribute.FileStoreAttributeView getFileStoreAttributeView(java.lang.Class)>/this#_0	org.springframework.boot.loader.nio.file.NestedFileStore
<org.springframework.boot.loader.nio.file.NestedFileStore: java.nio.file.attribute.FileStoreAttributeView getFileStoreAttributeView(java.lang.Class)>/type#_0	java.lang.Class
<org.springframework.boot.loader.nio.file.NestedFileStore: java.nio.file.attribute.FileStoreAttributeView getFileStoreAttributeView(java.lang.Class)>/$stack2	java.nio.file.FileStore
<org.springframework.boot.loader.nio.file.NestedFileStore: java.nio.file.attribute.FileStoreAttributeView getFileStoreAttributeView(java.lang.Class)>/$stack3	java.nio.file.attribute.FileStoreAttributeView
<org.springframework.boot.loader.nio.file.NestedFileStore: java.lang.Object getAttribute(java.lang.String)>/@this	org.springframework.boot.loader.nio.file.NestedFileStore
<org.springframework.boot.loader.nio.file.NestedFileStore: java.lang.Object getAttribute(java.lang.String)>/@parameter0	java.lang.String
<org.springframework.boot.loader.nio.file.NestedFileStore: java.lang.Object getAttribute(java.lang.String)>/this#_0	org.springframework.boot.loader.nio.file.NestedFileStore
<org.springframework.boot.loader.nio.file.NestedFileStore: java.lang.Object getAttribute(java.lang.String)>/attribute#_0	java.lang.String
<org.springframework.boot.loader.nio.file.NestedFileStore: java.lang.Object getAttribute(java.lang.String)>/$stack3	java.nio.file.FileStore
<org.springframework.boot.loader.nio.file.NestedFileStore: java.lang.Object getAttribute(java.lang.String)>/$stack4	java.lang.Object
<org.springframework.boot.loader.nio.file.NestedFileStore: java.lang.Object getAttribute(java.lang.String)>/$stack5	java.io.UncheckedIOException
<org.springframework.boot.loader.nio.file.NestedFileStore: java.lang.Object getAttribute(java.lang.String)>/$stack6	java.io.IOException
<org.springframework.boot.loader.nio.file.NestedFileStore: java.nio.file.FileStore getJarPathFileStore()>/@this	org.springframework.boot.loader.nio.file.NestedFileStore
<org.springframework.boot.loader.nio.file.NestedFileStore: java.nio.file.FileStore getJarPathFileStore()>/this#_0	org.springframework.boot.loader.nio.file.NestedFileStore
<org.springframework.boot.loader.nio.file.NestedFileStore: java.nio.file.FileStore getJarPathFileStore()>/$stack2	org.springframework.boot.loader.nio.file.NestedFileSystem
<org.springframework.boot.loader.nio.file.NestedFileStore: java.nio.file.FileStore getJarPathFileStore()>/$stack3	java.nio.file.Path
<org.springframework.boot.loader.nio.file.NestedFileStore: java.nio.file.FileStore getJarPathFileStore()>/$stack4	java.nio.file.FileStore
<org.springframework.boot.loader.nio.file.NestedFileStore: java.nio.file.FileStore getJarPathFileStore()>/$stack5	java.io.IOException
<org.springframework.boot.loader.nio.file.NestedFileStore: java.nio.file.FileStore getJarPathFileStore()>/$stack6	java.io.UncheckedIOException
<org.springframework.boot.loader.net.protocol.jar.Canonicalizer: void <init>()>/@this	org.springframework.boot.loader.net.protocol.jar.Canonicalizer
<org.springframework.boot.loader.net.protocol.jar.Canonicalizer: void <init>()>/this#_0	org.springframework.boot.loader.net.protocol.jar.Canonicalizer
<org.springframework.boot.loader.net.protocol.jar.Canonicalizer: java.lang.String canonicalizeAfter(java.lang.String,int)>/@parameter0	java.lang.String
<org.springframework.boot.loader.net.protocol.jar.Canonicalizer: java.lang.String canonicalizeAfter(java.lang.String,int)>/@parameter1	int
<org.springframework.boot.loader.zip.Zip64EndOfCentralDirectoryRecord: java.lang.String toString()>/@this	org.springframework.boot.loader.zip.Zip64EndOfCentralDirectoryRecord
<org.springframework.boot.loader.zip.Zip64EndOfCentralDirectoryRecord: java.lang.String toString()>/this#_0	org.springframework.boot.loader.zip.Zip64EndOfCentralDirectoryRecord
<org.springframework.boot.loader.zip.Zip64EndOfCentralDirectoryRecord: java.lang.String toString()>/$stack1	java.lang.String
<org.springframework.boot.loader.net.protocol.jar.Canonicalizer: java.lang.String canonicalizeAfter(java.lang.String,int)>/path#_0	java.lang.String
<org.springframework.boot.loader.net.protocol.jar.Canonicalizer: java.lang.String canonicalizeAfter(java.lang.String,int)>/pathLength#_32	int
<org.springframework.boot.loader.net.protocol.jar.Canonicalizer: java.lang.String canonicalizeAfter(java.lang.String,int)>/pos#_0	int
<org.springframework.boot.loader.net.protocol.jar.Canonicalizer: java.lang.String canonicalizeAfter(java.lang.String,int)>/$stack6	int
<org.springframework.boot.loader.net.protocol.jar.Canonicalizer: java.lang.String canonicalizeAfter(java.lang.String,int)>/$stack7	java.lang.String
<org.springframework.boot.loader.net.protocol.jar.Canonicalizer: java.lang.String canonicalizeAfter(java.lang.String,int)>/$stack8	java.lang.String
<org.springframework.boot.loader.net.protocol.jar.Canonicalizer: java.lang.String canonicalizeAfter(java.lang.String,int)>/$stack9	int
<org.springframework.boot.loader.net.protocol.jar.Canonicalizer: java.lang.String canonicalizeAfter(java.lang.String,int)>/$stack10	char
<org.springframework.boot.loader.net.protocol.jar.Canonicalizer: java.lang.String canonicalizeAfter(java.lang.String,int)>/$stack14	java.lang.String
<org.springframework.boot.loader.net.protocol.jar.Canonicalizer: java.lang.String canonicalizeAfter(java.lang.String,int)>/$stack17	java.lang.String
<org.springframework.boot.loader.net.protocol.jar.Canonicalizer: java.lang.String canonicalizeAfter(java.lang.String,int)>/$stack21	boolean
<org.springframework.boot.loader.net.protocol.jar.Canonicalizer: java.lang.String canonicalizeAfter(java.lang.String,int)>/$i0	int
<org.springframework.boot.loader.net.protocol.jar.Canonicalizer: java.lang.String canonicalizeAfter(java.lang.String,int)>/$i1	int
<org.springframework.boot.loader.net.protocol.jar.Canonicalizer: java.lang.String canonicalizeAfter(java.lang.String,int)>/$stack21_$$A_1	boolean
<org.springframework.boot.loader.net.protocol.jar.Canonicalizer: java.lang.String canonicalizeAfter(java.lang.String,int)>/$stack21_$$A_2	boolean
<org.springframework.boot.loader.net.protocol.jar.Canonicalizer: java.lang.String canonicalizeAfter(java.lang.String,int)>/$stringconstant0	java.lang.String
<org.springframework.boot.loader.zip.Zip64EndOfCentralDirectoryRecord: java.lang.String toString()>/$classconstant0	java.lang.Class
<org.springframework.boot.loader.zip.Zip64EndOfCentralDirectoryRecord: java.lang.String toString()>/$stringconstant0	java.lang.String
<org.springframework.boot.loader.zip.Zip64EndOfCentralDirectoryRecord: java.lang.String toString()>/$mhandleconstant0	java.lang.invoke.MethodHandle
<org.springframework.boot.loader.net.protocol.jar.Canonicalizer: java.lang.String canonicalizeAfter(java.lang.String,int)>/$numconstant0	int
<org.springframework.boot.loader.net.protocol.jar.Canonicalizer: java.lang.String canonicalizeAfter(java.lang.String,int)>/$stringconstant1	java.lang.String
<org.springframework.boot.loader.net.protocol.jar.Canonicalizer: java.lang.String canonicalize(java.lang.String)>/@parameter0	java.lang.String
<org.springframework.boot.loader.net.protocol.jar.Canonicalizer: java.lang.String canonicalize(java.lang.String)>/path#_0	java.lang.String
<org.springframework.boot.loader.net.protocol.jar.Canonicalizer: java.lang.String canonicalize(java.lang.String)>/path#2#_43	java.lang.String
<org.springframework.boot.loader.net.protocol.jar.Canonicalizer: java.lang.String canonicalize(java.lang.String)>/path#2_$$A_1#_44	java.lang.String
<org.springframework.boot.loader.net.protocol.jar.Canonicalizer: java.lang.String canonicalize(java.lang.String)>/path#2_$$A_2#_45	java.lang.String
<org.springframework.boot.loader.net.protocol.jar.Canonicalizer: java.lang.String canonicalize(java.lang.String)>/path#2_$$A_3#_46	java.lang.String
<org.springframework.boot.loader.net.protocol.jar.Canonicalizer: java.lang.String removeEmbeddedSlashDotDotSlash(java.lang.String)>/@parameter0	java.lang.String
<org.springframework.boot.loader.net.protocol.jar.Canonicalizer: java.lang.String removeEmbeddedSlashDotDotSlash(java.lang.String)>/$stack4	int
<org.springframework.boot.loader.net.protocol.jar.Canonicalizer: java.lang.String removeEmbeddedSlashDotDotSlash(java.lang.String)>/$stack5	int
<org.springframework.boot.loader.net.protocol.jar.Canonicalizer: java.lang.String removeEmbeddedSlashDotDotSlash(java.lang.String)>/priorSlash#_53	int
<org.springframework.boot.loader.net.protocol.jar.Canonicalizer: java.lang.String removeEmbeddedSlashDotDotSlash(java.lang.String)>/$stack6	int
<org.springframework.boot.loader.net.protocol.jar.Canonicalizer: java.lang.String removeEmbeddedSlashDotDotSlash(java.lang.String)>/after#_54	java.lang.String
<org.springframework.boot.loader.net.protocol.jar.Canonicalizer: java.lang.String removeEmbeddedSlashDotDotSlash(java.lang.String)>/$stack9	java.lang.String
<org.springframework.boot.loader.net.protocol.jar.Canonicalizer: java.lang.String removeEmbeddedSlashDotDotSlash(java.lang.String)>/path#_0	java.lang.String
<org.springframework.boot.loader.net.protocol.jar.Canonicalizer: java.lang.String removeEmbeddedSlashDotDotSlash(java.lang.String)>/$stack10	java.lang.String
<org.springframework.boot.loader.net.protocol.jar.Canonicalizer: java.lang.String removeEmbeddedSlashDotDotSlash(java.lang.String)>/path_$$A_1#_1	java.lang.String
<org.springframework.boot.loader.net.protocol.jar.Canonicalizer: java.lang.String removeEmbeddedSlashDotDotSlash(java.lang.String)>/$stack10_$$A_1	java.lang.String
<org.springframework.boot.loader.net.protocol.jar.Canonicalizer: java.lang.String removeEmbeddedSlashDotDotSlash(java.lang.String)>/$stack10_$$A_2	java.lang.String
<org.springframework.boot.loader.net.protocol.jar.Canonicalizer: java.lang.String removeEmbeddedSlashDotDotSlash(java.lang.String)>/$stack10_$$A_3	java.lang.String
<org.springframework.boot.loader.net.protocol.jar.Canonicalizer: java.lang.String removeEmbeddedSlashDotDotSlash(java.lang.String)>/path_$$A_2#_55	java.lang.String
<org.springframework.boot.loader.net.protocol.jar.Canonicalizer: java.lang.String removeEmbeddedSlashDotDotSlash(java.lang.String)>/$stringconstant0	java.lang.String
<org.springframework.boot.loader.net.protocol.jar.Canonicalizer: java.lang.String removeEmbeddedSlashDotDotSlash(java.lang.String)>/$numconstant0	int
<org.springframework.boot.loader.net.protocol.jar.Canonicalizer: java.lang.String removeEmbeddedSlashDotDotSlash(java.lang.String)>/$numconstant1	int
<org.springframework.boot.loader.net.protocol.jar.Canonicalizer: java.lang.String removeEmbeddedSlashDotDotSlash(java.lang.String)>/$stringconstant1	java.lang.String
<org.springframework.boot.loader.net.protocol.jar.Canonicalizer: java.lang.String removeEmbeddedSlashDotSlash(java.lang.String)>/@parameter0	java.lang.String
<org.springframework.boot.loader.net.protocol.jar.Canonicalizer: java.lang.String removeEmbeddedSlashDotSlash(java.lang.String)>/$stack4	int
<org.springframework.boot.loader.net.protocol.jar.Canonicalizer: java.lang.String removeEmbeddedSlashDotSlash(java.lang.String)>/before#_63	java.lang.String
<org.springframework.boot.loader.net.protocol.jar.Canonicalizer: java.lang.String removeEmbeddedSlashDotSlash(java.lang.String)>/$stack5	int
<org.springframework.boot.loader.net.protocol.jar.Canonicalizer: java.lang.String removeEmbeddedSlashDotSlash(java.lang.String)>/after#_64	java.lang.String
<org.springframework.boot.loader.net.protocol.jar.Canonicalizer: java.lang.String removeEmbeddedSlashDotSlash(java.lang.String)>/path#_0	java.lang.String
<org.springframework.boot.loader.net.protocol.jar.Canonicalizer: java.lang.String removeEmbeddedSlashDotSlash(java.lang.String)>/path_$$A_1#_1	java.lang.String
<org.springframework.boot.loader.net.protocol.jar.Canonicalizer: java.lang.String removeEmbeddedSlashDotSlash(java.lang.String)>/path_$$A_2#_65	java.lang.String
<org.springframework.boot.loader.net.protocol.jar.Canonicalizer: java.lang.String removeEmbeddedSlashDotSlash(java.lang.String)>/$stringconstant0	java.lang.String
<org.springframework.boot.loader.net.protocol.jar.Canonicalizer: java.lang.String removeEmbeddedSlashDotSlash(java.lang.String)>/$numconstant0	int
<org.springframework.boot.loader.net.protocol.jar.Canonicalizer: java.lang.String removeEmbeddedSlashDotSlash(java.lang.String)>/$stringconstant1	java.lang.String
<org.springframework.boot.loader.net.protocol.jar.Canonicalizer: java.lang.String removeTrailingSlashDot(java.lang.String)>/@parameter0	java.lang.String
<org.springframework.boot.loader.net.protocol.jar.Canonicalizer: java.lang.String removeTrailingSlashDot(java.lang.String)>/path#_0	java.lang.String
<org.springframework.boot.loader.net.protocol.jar.Canonicalizer: java.lang.String removeTrailingSlashDot(java.lang.String)>/$stack1	boolean
<org.springframework.boot.loader.net.protocol.jar.Canonicalizer: java.lang.String removeTrailingSlashDot(java.lang.String)>/$stack2	int
<org.springframework.boot.loader.net.protocol.jar.Canonicalizer: java.lang.String removeTrailingSlashDot(java.lang.String)>/$stack3	int
<org.springframework.boot.loader.net.protocol.jar.Canonicalizer: java.lang.String removeTrailingSlashDot(java.lang.String)>/$stack4	java.lang.String
<org.springframework.boot.loader.net.protocol.jar.Canonicalizer: java.lang.String removeTrailingSlashDot(java.lang.String)>/$stack4_$$A_1	java.lang.String
<org.springframework.boot.loader.net.protocol.jar.Canonicalizer: java.lang.String removeTrailingSlashDot(java.lang.String)>/$stack4_$$A_2	java.lang.String
<org.springframework.boot.loader.net.protocol.jar.Canonicalizer: java.lang.String removeTrailingSlashDot(java.lang.String)>/$stringconstant0	java.lang.String
<org.springframework.boot.loader.net.protocol.jar.Canonicalizer: java.lang.String removeTrailingSlashDot(java.lang.String)>/$numconstant0	int
<org.springframework.boot.loader.net.protocol.jar.Canonicalizer: java.lang.String removeTrailingSlashDotDot(java.lang.String)>/@parameter0	java.lang.String
<org.springframework.boot.loader.net.protocol.jar.Canonicalizer: java.lang.String removeTrailingSlashDotDot(java.lang.String)>/$stack3	boolean
<org.springframework.boot.loader.net.protocol.jar.Canonicalizer: java.lang.String removeTrailingSlashDotDot(java.lang.String)>/index#_77	int
<org.springframework.boot.loader.net.protocol.jar.Canonicalizer: java.lang.String removeTrailingSlashDotDot(java.lang.String)>/$stack4	int
<org.springframework.boot.loader.net.protocol.jar.Canonicalizer: java.lang.String removeTrailingSlashDotDot(java.lang.String)>/priorSlash#_78	int
<org.springframework.boot.loader.net.protocol.jar.Canonicalizer: java.lang.String removeTrailingSlashDotDot(java.lang.String)>/$stack7	int
<org.springframework.boot.loader.net.protocol.jar.Canonicalizer: java.lang.String removeTrailingSlashDotDot(java.lang.String)>/path#_0	java.lang.String
<org.springframework.boot.loader.net.protocol.jar.Canonicalizer: java.lang.String removeTrailingSlashDotDot(java.lang.String)>/$stack8	java.lang.String
<org.springframework.boot.loader.net.protocol.jar.Canonicalizer: java.lang.String removeTrailingSlashDotDot(java.lang.String)>/path_$$A_1#_1	java.lang.String
<org.springframework.boot.loader.net.protocol.jar.Canonicalizer: java.lang.String removeTrailingSlashDotDot(java.lang.String)>/$stack8_$$A_1	java.lang.String
<org.springframework.boot.loader.net.protocol.jar.Canonicalizer: java.lang.String removeTrailingSlashDotDot(java.lang.String)>/$stack8_$$A_2	java.lang.String
<org.springframework.boot.loader.net.protocol.jar.Canonicalizer: java.lang.String removeTrailingSlashDotDot(java.lang.String)>/$stack8_$$A_3	java.lang.String
<org.springframework.boot.loader.net.protocol.jar.Canonicalizer: java.lang.String removeTrailingSlashDotDot(java.lang.String)>/path_$$A_2#_79	java.lang.String
<org.springframework.boot.loader.net.protocol.jar.Canonicalizer: java.lang.String removeTrailingSlashDotDot(java.lang.String)>/$stringconstant0	java.lang.String
<org.springframework.boot.loader.net.protocol.jar.Canonicalizer: java.lang.String removeTrailingSlashDotDot(java.lang.String)>/$stringconstant1	java.lang.String
<org.springframework.boot.loader.net.protocol.jar.Canonicalizer: java.lang.String removeTrailingSlashDotDot(java.lang.String)>/$numconstant0	int
<org.springframework.boot.loader.net.protocol.jar.Canonicalizer: java.lang.String removeTrailingSlashDotDot(java.lang.String)>/$numconstant1	int
<org.springframework.boot.loader.net.protocol.jar.Canonicalizer: java.lang.String removeTrailingSlashDotDot(java.lang.String)>/$numconstant2	int
<org.springframework.boot.loader.launch.Launcher: void <init>()>/@this	org.springframework.boot.loader.launch.Launcher
<org.springframework.boot.loader.launch.Launcher: void <init>()>/this#_0	org.springframework.boot.loader.launch.Launcher
<org.springframework.boot.loader.launch.Launcher: void launch(java.lang.String[])>/@this	org.springframework.boot.loader.launch.Launcher
<org.springframework.boot.loader.launch.Launcher: void launch(java.lang.String[])>/@parameter0	java.lang.String[]
<org.springframework.boot.loader.launch.Launcher: void launch(java.lang.String[])>/this#_0	org.springframework.boot.loader.launch.Launcher
<org.springframework.boot.loader.launch.Launcher: void launch(java.lang.String[])>/$stack5	boolean
<org.springframework.boot.loader.launch.Launcher: void launch(java.lang.String[])>/$stack6	java.util.Set
<org.springframework.boot.loader.launch.Launcher: void launch(java.lang.String[])>/$stack7	boolean
<org.springframework.boot.loader.launch.Launcher: void launch(java.lang.String[])>/args#_0	java.lang.String[]
<org.springframework.boot.loader.launch.Launcher: void launch(java.lang.String[])>/$stack15	java.lang.ClassLoader
<org.springframework.boot.loader.launch.Launcher: void launch(java.lang.String[])>/$stack17	java.lang.String
<org.springframework.boot.loader.launch.Launcher: void launch(java.lang.String[])>/$stack20	java.io.UncheckedIOException
<org.springframework.boot.loader.launch.Launcher: void launch(java.lang.String[])>/$stack21	java.io.IOException
<org.springframework.boot.loader.launch.Launcher: void launch(java.lang.String[])>/$stack8	java.lang.String
<org.springframework.boot.loader.launch.Launcher: void launch(java.lang.String[])>/$stack8_$$A_1	java.lang.String
<org.springframework.boot.loader.launch.Launcher: void launch(java.lang.String[])>/$stack8_$$A_2	java.lang.String
<org.springframework.boot.loader.launch.Launcher: void launch(java.lang.String[])>/$stack8_$$A_3	java.lang.String
<org.springframework.boot.loader.launch.Launcher: void launch(java.lang.String[])>/$stringconstant0	java.lang.String
<org.springframework.boot.loader.launch.Launcher: boolean hasLength(java.lang.String)>/@this	org.springframework.boot.loader.launch.Launcher
<org.springframework.boot.loader.launch.Launcher: boolean hasLength(java.lang.String)>/@parameter0	java.lang.String
<org.springframework.boot.loader.launch.Launcher: boolean hasLength(java.lang.String)>/jarMode#_0	java.lang.String
<org.springframework.boot.loader.launch.Launcher: boolean hasLength(java.lang.String)>/$stack2	boolean
<org.springframework.boot.loader.launch.Launcher: boolean hasLength(java.lang.String)>/this#_0	org.springframework.boot.loader.launch.Launcher
<org.springframework.boot.loader.launch.Launcher: boolean hasLength(java.lang.String)>/$stack3	boolean
<org.springframework.boot.loader.launch.Launcher: boolean hasLength(java.lang.String)>/$stack3_$$A_1	boolean
<org.springframework.boot.loader.launch.Launcher: boolean hasLength(java.lang.String)>/$stack3_$$A_2	boolean
<org.springframework.boot.loader.launch.Launcher: java.lang.ClassLoader createClassLoader(java.util.Collection)>/@this	org.springframework.boot.loader.launch.Launcher
<org.springframework.boot.loader.launch.Launcher: java.lang.ClassLoader createClassLoader(java.util.Collection)>/@parameter0	java.util.Collection
<org.springframework.boot.loader.launch.Launcher: java.lang.ClassLoader createClassLoader(java.util.Collection)>/this#_0	org.springframework.boot.loader.launch.Launcher
<org.springframework.boot.loader.launch.Launcher: java.lang.ClassLoader createClassLoader(java.util.Collection)>/urls#_0	java.util.Collection
<org.springframework.boot.loader.launch.Launcher: java.lang.ClassLoader createClassLoader(java.util.Collection)>/$stack2	java.net.URL[]
<org.springframework.boot.loader.launch.Launcher: java.lang.ClassLoader createClassLoader(java.util.Collection)>/$stack3	java.lang.Object[]
<org.springframework.boot.loader.launch.Launcher: java.lang.ClassLoader createClassLoader(java.util.Collection)>/$stack4	java.net.URL[]
<org.springframework.boot.loader.launch.Launcher: java.lang.ClassLoader createClassLoader(java.util.Collection)>/$stack5	java.lang.ClassLoader
<org.springframework.boot.loader.launch.Launcher: java.lang.ClassLoader createClassLoader(java.net.URL[])>/@this	org.springframework.boot.loader.launch.Launcher
<org.springframework.boot.loader.launch.Launcher: java.lang.ClassLoader createClassLoader(java.net.URL[])>/@parameter0	java.net.URL[]
<org.springframework.boot.loader.launch.Launcher: java.lang.ClassLoader createClassLoader(java.net.URL[])>/this#_0	org.springframework.boot.loader.launch.Launcher
<org.springframework.boot.loader.launch.Launcher: java.lang.ClassLoader createClassLoader(java.net.URL[])>/$stack3	java.lang.Class
<org.springframework.boot.loader.launch.Launcher: java.lang.ClassLoader createClassLoader(java.net.URL[])>/parent#_75	java.lang.ClassLoader
<org.springframework.boot.loader.launch.Launcher: java.lang.ClassLoader createClassLoader(java.net.URL[])>/$stack4	org.springframework.boot.loader.launch.LaunchedClassLoader
<org.springframework.boot.loader.launch.Launcher: java.lang.ClassLoader createClassLoader(java.net.URL[])>/urls#_0	java.net.URL[]
<org.springframework.boot.loader.launch.Launcher: java.lang.ClassLoader createClassLoader(java.net.URL[])>/$stack5	org.springframework.boot.loader.launch.Archive
<org.springframework.boot.loader.launch.Launcher: java.lang.ClassLoader createClassLoader(java.net.URL[])>/$stack6	boolean
<org.springframework.boot.loader.launch.Launcher: void launch(java.lang.ClassLoader,java.lang.String,java.lang.String[])>/@this	org.springframework.boot.loader.launch.Launcher
<org.springframework.boot.loader.launch.Launcher: void launch(java.lang.ClassLoader,java.lang.String,java.lang.String[])>/@parameter0	java.lang.ClassLoader
<org.springframework.boot.loader.launch.Launcher: void launch(java.lang.ClassLoader,java.lang.String,java.lang.String[])>/@parameter1	java.lang.String
<org.springframework.boot.loader.launch.Launcher: void launch(java.lang.ClassLoader,java.lang.String,java.lang.String[])>/@parameter2	java.lang.String[]
<org.springframework.boot.loader.launch.Launcher: void launch(java.lang.ClassLoader,java.lang.String,java.lang.String[])>/classLoader#_0	java.lang.ClassLoader
<org.springframework.boot.loader.launch.Launcher: void launch(java.lang.ClassLoader,java.lang.String,java.lang.String[])>/$stack6	java.lang.Thread
<org.springframework.boot.loader.launch.Launcher: void launch(java.lang.ClassLoader,java.lang.String,java.lang.String[])>/mainClassName#_0	java.lang.String
<org.springframework.boot.loader.launch.Launcher: void launch(java.lang.ClassLoader,java.lang.String,java.lang.String[])>/mainClass#_88	java.lang.Class
<org.springframework.boot.loader.launch.Launcher: void launch(java.lang.ClassLoader,java.lang.String,java.lang.String[])>/$stack7	java.lang.Class[]
<org.springframework.boot.loader.launch.Launcher: void launch(java.lang.ClassLoader,java.lang.String,java.lang.String[])>/mainMethod#_89	java.lang.reflect.Method
<org.springframework.boot.loader.launch.Launcher: void launch(java.lang.ClassLoader,java.lang.String,java.lang.String[])>/$stack8	java.lang.Object[]
<org.springframework.boot.loader.launch.Launcher: void launch(java.lang.ClassLoader,java.lang.String,java.lang.String[])>/args#_0	java.lang.String[]
<org.springframework.boot.loader.launch.Launcher: void launch(java.lang.ClassLoader,java.lang.String,java.lang.String[])>/this#_0	org.springframework.boot.loader.launch.Launcher
<org.springframework.boot.loader.launch.Launcher: void launch(java.lang.ClassLoader,java.lang.String,java.lang.String[])>/$numconstant0	int
<org.springframework.boot.loader.launch.Launcher: void launch(java.lang.ClassLoader,java.lang.String,java.lang.String[])>/$classconstant0	java.lang.Class
<org.springframework.boot.loader.launch.Launcher: void launch(java.lang.ClassLoader,java.lang.String,java.lang.String[])>/$stringconstant0	java.lang.String
<org.springframework.boot.loader.launch.Launcher: void launch(java.lang.ClassLoader,java.lang.String,java.lang.String[])>/$numconstant1	int
<org.springframework.boot.loader.launch.Launcher: void launch(java.lang.ClassLoader,java.lang.String,java.lang.String[])>/$null0	java.lang.Object
<org.springframework.boot.loader.launch.Launcher: boolean isExploded()>/@this	org.springframework.boot.loader.launch.Launcher
<org.springframework.boot.loader.launch.Launcher: boolean isExploded()>/this#_0	org.springframework.boot.loader.launch.Launcher
<org.springframework.boot.loader.launch.Launcher: boolean isExploded()>/archive#_101	org.springframework.boot.loader.launch.Archive
<org.springframework.boot.loader.launch.Launcher: boolean isExploded()>/$stack2	boolean
<org.springframework.boot.loader.launch.Launcher: boolean isExploded()>/$stack3	boolean
<org.springframework.boot.loader.launch.Launcher: boolean isExploded()>/$stack3_$$A_1	boolean
<org.springframework.boot.loader.launch.Launcher: boolean isExploded()>/$stack3_$$A_2	boolean
<org.springframework.boot.loader.launch.Launcher: org.springframework.boot.loader.launch.Archive getArchive()>/@this	org.springframework.boot.loader.launch.Launcher
<org.springframework.boot.loader.launch.Launcher: java.lang.String getMainClass()>/@this	org.springframework.boot.loader.launch.Launcher
<org.springframework.boot.loader.launch.Launcher: java.util.Set getClassPathUrls()>/@this	org.springframework.boot.loader.launch.Launcher
<org.springframework.boot.loader.launch.Launcher: void <clinit>()>/$stack0	java.lang.Class
<org.springframework.boot.loader.launch.Launcher: void <clinit>()>/$stack1	java.lang.String
<org.springframework.boot.loader.jar.NestedJarFile: void <init>(java.io.File)>/@this	org.springframework.boot.loader.jar.NestedJarFile
<org.springframework.boot.loader.jar.NestedJarFile: void <init>(java.io.File)>/@parameter0	java.io.File
<org.springframework.boot.loader.jar.NestedJarFile: void <init>(java.io.File)>/this#_0	org.springframework.boot.loader.jar.NestedJarFile
<org.springframework.boot.loader.jar.NestedJarFile: void <init>(java.io.File)>/file#_0	java.io.File
<org.springframework.boot.loader.jar.NestedJarFile: void <init>(java.io.File)>/$stack2	org.springframework.boot.loader.ref.Cleaner
<org.springframework.boot.loader.jar.NestedJarFile: void <init>(java.io.File)>/$null0	java.lang.String
<org.springframework.boot.loader.jar.NestedJarFile: void <init>(java.io.File)>/$null1	java.lang.Runtime$Version
<org.springframework.boot.loader.jar.NestedJarFile: void <init>(java.io.File)>/$numconstant0	int
<org.springframework.boot.loader.jar.NestedJarFile: void <init>(java.io.File,java.lang.String)>/@this	org.springframework.boot.loader.jar.NestedJarFile
<org.springframework.boot.loader.jar.NestedJarFile: void <init>(java.io.File,java.lang.String)>/@parameter0	java.io.File
<org.springframework.boot.loader.jar.NestedJarFile: void <init>(java.io.File,java.lang.String)>/@parameter1	java.lang.String
<org.springframework.boot.loader.jar.NestedJarFile: void <init>(java.io.File,java.lang.String)>/this#_0	org.springframework.boot.loader.jar.NestedJarFile
<org.springframework.boot.loader.jar.NestedJarFile: void <init>(java.io.File,java.lang.String)>/file#_0	java.io.File
<org.springframework.boot.loader.jar.NestedJarFile: void <init>(java.io.File,java.lang.String)>/nestedEntryName#_0	java.lang.String
<org.springframework.boot.loader.jar.NestedJarFile: void <init>(java.io.File,java.lang.String)>/$stack3	org.springframework.boot.loader.ref.Cleaner
<org.springframework.boot.loader.jar.NestedJarFile: void <init>(java.io.File,java.lang.String)>/$null0	java.lang.Runtime$Version
<org.springframework.boot.loader.jar.NestedJarFile: void <init>(java.io.File,java.lang.String)>/$numconstant0	int
<org.springframework.boot.loader.jar.NestedJarFile: void <init>(java.io.File,java.lang.String,java.lang.Runtime$Version)>/@this	org.springframework.boot.loader.jar.NestedJarFile
<org.springframework.boot.loader.jar.NestedJarFile: void <init>(java.io.File,java.lang.String,java.lang.Runtime$Version)>/@parameter0	java.io.File
<org.springframework.boot.loader.jar.NestedJarFile: void <init>(java.io.File,java.lang.String,java.lang.Runtime$Version)>/@parameter1	java.lang.String
<org.springframework.boot.loader.jar.NestedJarFile: void <init>(java.io.File,java.lang.String,java.lang.Runtime$Version)>/@parameter2	java.lang.Runtime$Version
<org.springframework.boot.loader.jar.NestedJarFile: void <init>(java.io.File,java.lang.String,java.lang.Runtime$Version)>/this#_0	org.springframework.boot.loader.jar.NestedJarFile
<org.springframework.boot.loader.jar.NestedJarFile: void <init>(java.io.File,java.lang.String,java.lang.Runtime$Version)>/file#_0	java.io.File
<org.springframework.boot.loader.jar.NestedJarFile: void <init>(java.io.File,java.lang.String,java.lang.Runtime$Version)>/nestedEntryName#_0	java.lang.String
<org.springframework.boot.loader.jar.NestedJarFile: void <init>(java.io.File,java.lang.String,java.lang.Runtime$Version)>/version#_0	java.lang.Runtime$Version
<org.springframework.boot.loader.jar.NestedJarFile: void <init>(java.io.File,java.lang.String,java.lang.Runtime$Version)>/$stack4	org.springframework.boot.loader.ref.Cleaner
<org.springframework.boot.loader.jar.NestedJarFile: void <init>(java.io.File,java.lang.String,java.lang.Runtime$Version)>/$numconstant0	int
<org.springframework.boot.loader.jar.NestedJarFile: void <init>(java.io.File,java.lang.String,java.lang.Runtime$Version,boolean,org.springframework.boot.loader.ref.Cleaner)>/@this	org.springframework.boot.loader.jar.NestedJarFile
<org.springframework.boot.loader.jar.NestedJarFile: void <init>(java.io.File,java.lang.String,java.lang.Runtime$Version,boolean,org.springframework.boot.loader.ref.Cleaner)>/@parameter0	java.io.File
<org.springframework.boot.loader.jar.NestedJarFile: void <init>(java.io.File,java.lang.String,java.lang.Runtime$Version,boolean,org.springframework.boot.loader.ref.Cleaner)>/@parameter1	java.lang.String
<org.springframework.boot.loader.jar.NestedJarFile: void <init>(java.io.File,java.lang.String,java.lang.Runtime$Version,boolean,org.springframework.boot.loader.ref.Cleaner)>/@parameter2	java.lang.Runtime$Version
<org.springframework.boot.loader.jar.NestedJarFile: void <init>(java.io.File,java.lang.String,java.lang.Runtime$Version,boolean,org.springframework.boot.loader.ref.Cleaner)>/@parameter3	boolean
<org.springframework.boot.loader.jar.NestedJarFile: void <init>(java.io.File,java.lang.String,java.lang.Runtime$Version,boolean,org.springframework.boot.loader.ref.Cleaner)>/@parameter4	org.springframework.boot.loader.ref.Cleaner
<org.springframework.boot.loader.jar.NestedJarFile: void <init>(java.io.File,java.lang.String,java.lang.Runtime$Version,boolean,org.springframework.boot.loader.ref.Cleaner)>/this#_0	org.springframework.boot.loader.jar.NestedJarFile
<org.springframework.boot.loader.jar.NestedJarFile: void <init>(java.io.File,java.lang.String,java.lang.Runtime$Version,boolean,org.springframework.boot.loader.ref.Cleaner)>/file#_0	java.io.File
<org.springframework.boot.loader.jar.NestedJarFile: void <init>(java.io.File,java.lang.String,java.lang.Runtime$Version,boolean,org.springframework.boot.loader.ref.Cleaner)>/onlyNestedJars#_0	boolean
<org.springframework.boot.loader.jar.NestedJarFile: void <init>(java.io.File,java.lang.String,java.lang.Runtime$Version,boolean,org.springframework.boot.loader.ref.Cleaner)>/nestedEntryName#_0	java.lang.String
<org.springframework.boot.loader.jar.NestedJarFile: void <init>(java.io.File,java.lang.String,java.lang.Runtime$Version,boolean,org.springframework.boot.loader.ref.Cleaner)>/version#_0	java.lang.Runtime$Version
<org.springframework.boot.loader.jar.NestedJarFile: void <init>(java.io.File,java.lang.String,java.lang.Runtime$Version,boolean,org.springframework.boot.loader.ref.Cleaner)>/$stack6	org.springframework.boot.loader.log.DebugLogger
<org.springframework.boot.loader.jar.NestedJarFile: void <init>(java.io.File,java.lang.String,java.lang.Runtime$Version,boolean,org.springframework.boot.loader.ref.Cleaner)>/cleaner#_0	org.springframework.boot.loader.ref.Cleaner
<org.springframework.boot.loader.jar.NestedJarFile: void <init>(java.io.File,java.lang.String,java.lang.Runtime$Version,boolean,org.springframework.boot.loader.ref.Cleaner)>/$stack7	org.springframework.boot.loader.jar.NestedJarFileResources
<org.springframework.boot.loader.jar.NestedJarFile: void <init>(java.io.File,java.lang.String,java.lang.Runtime$Version,boolean,org.springframework.boot.loader.ref.Cleaner)>/$stack8	org.springframework.boot.loader.jar.NestedJarFileResources
<org.springframework.boot.loader.jar.NestedJarFile: void <init>(java.io.File,java.lang.String,java.lang.Runtime$Version,boolean,org.springframework.boot.loader.ref.Cleaner)>/$stack9	java.lang.ref.Cleaner$Cleanable
<org.springframework.boot.loader.jar.NestedJarFile: void <init>(java.io.File,java.lang.String,java.lang.Runtime$Version,boolean,org.springframework.boot.loader.ref.Cleaner)>/$stack10	java.lang.String
<org.springframework.boot.loader.jar.NestedJarFile: void <init>(java.io.File,java.lang.String,java.lang.Runtime$Version,boolean,org.springframework.boot.loader.ref.Cleaner)>/$stack11	java.lang.String
<org.springframework.boot.loader.jar.NestedJarFile: void <init>(java.io.File,java.lang.String,java.lang.Runtime$Version,boolean,org.springframework.boot.loader.ref.Cleaner)>/$stack12	java.lang.Runtime$Version
<org.springframework.boot.loader.jar.NestedJarFile: void <init>(java.io.File,java.lang.String,java.lang.Runtime$Version,boolean,org.springframework.boot.loader.ref.Cleaner)>/$stack18	java.lang.IllegalArgumentException
<org.springframework.boot.loader.jar.NestedJarFile: void <init>(java.io.File,java.lang.String,java.lang.Runtime$Version,boolean,org.springframework.boot.loader.ref.Cleaner)>/$stack19	boolean
<org.springframework.boot.loader.jar.NestedJarFile: void <init>(java.io.File,java.lang.String,java.lang.Runtime$Version,boolean,org.springframework.boot.loader.ref.Cleaner)>/$stack15	java.lang.String
<org.springframework.boot.loader.jar.NestedJarFile: void <init>(java.io.File,java.lang.String,java.lang.Runtime$Version,boolean,org.springframework.boot.loader.ref.Cleaner)>/$stack13	int
<org.springframework.boot.loader.jar.NestedJarFile: void <init>(java.io.File,java.lang.String,java.lang.Runtime$Version,boolean,org.springframework.boot.loader.ref.Cleaner)>/$stack15_$$A_1	java.lang.String
<org.springframework.boot.loader.jar.NestedJarFile: void <init>(java.io.File,java.lang.String,java.lang.Runtime$Version,boolean,org.springframework.boot.loader.ref.Cleaner)>/$stack15_$$A_2	java.lang.String
<org.springframework.boot.loader.jar.NestedJarFile: void <init>(java.io.File,java.lang.String,java.lang.Runtime$Version,boolean,org.springframework.boot.loader.ref.Cleaner)>/$stack13_$$A_1	int
<org.springframework.boot.loader.jar.NestedJarFile: void <init>(java.io.File,java.lang.String,java.lang.Runtime$Version,boolean,org.springframework.boot.loader.ref.Cleaner)>/$stack13_$$A_2	int
<org.springframework.boot.loader.jar.NestedJarFile: void <init>(java.io.File,java.lang.String,java.lang.Runtime$Version,boolean,org.springframework.boot.loader.ref.Cleaner)>/$stringconstant0	java.lang.String
<org.springframework.boot.loader.jar.NestedJarFile: void <init>(java.io.File,java.lang.String,java.lang.Runtime$Version,boolean,org.springframework.boot.loader.ref.Cleaner)>/$stringconstant1	java.lang.String
<org.springframework.boot.loader.jar.NestedJarFile: void <init>(java.io.File,java.lang.String,java.lang.Runtime$Version,boolean,org.springframework.boot.loader.ref.Cleaner)>/$stringconstant2	java.lang.String
<org.springframework.boot.loader.jar.NestedJarFile: void <init>(java.io.File,java.lang.String,java.lang.Runtime$Version,boolean,org.springframework.boot.loader.ref.Cleaner)>/$stringconstant3	java.lang.String
<org.springframework.boot.loader.jar.NestedJarFile: java.io.InputStream getRawZipDataInputStream()>/@this	org.springframework.boot.loader.jar.NestedJarFile
<org.springframework.boot.loader.jar.NestedJarFile: java.io.InputStream getRawZipDataInputStream()>/$stack2	org.springframework.boot.loader.jar.NestedJarFile$RawZipDataInputStream
<org.springframework.boot.loader.jar.NestedJarFile: java.io.InputStream getRawZipDataInputStream()>/this#_0	org.springframework.boot.loader.jar.NestedJarFile
<org.springframework.boot.loader.jar.NestedJarFile: java.io.InputStream getRawZipDataInputStream()>/$stack3	org.springframework.boot.loader.jar.NestedJarFileResources
<org.springframework.boot.loader.jar.NestedJarFile: java.io.InputStream getRawZipDataInputStream()>/$stack4	org.springframework.boot.loader.zip.ZipContent
<org.springframework.boot.loader.jar.NestedJarFile: java.io.InputStream getRawZipDataInputStream()>/$stack5	org.springframework.boot.loader.zip.CloseableDataBlock
<org.springframework.boot.loader.jar.NestedJarFile: java.io.InputStream getRawZipDataInputStream()>/$stack6	java.io.InputStream
<org.springframework.boot.loader.jar.NestedJarFile: java.io.InputStream getRawZipDataInputStream()>/$stack7	org.springframework.boot.loader.jar.NestedJarFileResources
<org.springframework.boot.loader.jar.NestedJarFile: java.util.jar.Manifest getManifest()>/@this	org.springframework.boot.loader.jar.NestedJarFile
<org.springframework.boot.loader.jar.NestedJarFile: java.util.jar.Manifest getManifest()>/this#_0	org.springframework.boot.loader.jar.NestedJarFile
<org.springframework.boot.loader.jar.NestedJarFile: java.util.jar.Manifest getManifest()>/$stack2	org.springframework.boot.loader.jar.NestedJarFileResources
<org.springframework.boot.loader.jar.NestedJarFile: java.util.jar.Manifest getManifest()>/$stack3	java.util.function.Function
<org.springframework.boot.loader.jar.NestedJarFile: java.util.jar.Manifest getManifest()>/$stack4	org.springframework.boot.loader.zip.ZipContent
<org.springframework.boot.loader.jar.NestedJarFile: java.util.jar.Manifest getManifest()>/$stack5	java.lang.Object
<org.springframework.boot.loader.jar.NestedJarFile: java.util.jar.Manifest getManifest()>/$stack6	org.springframework.boot.loader.jar.ManifestInfo
<org.springframework.boot.loader.jar.NestedJarFile: java.util.jar.Manifest getManifest()>/$stack7	java.util.jar.Manifest
<org.springframework.boot.loader.jar.NestedJarFile: java.util.jar.Manifest getManifest()>/$stack8	java.io.UncheckedIOException
<org.springframework.boot.loader.jar.NestedJarFile: java.util.jar.Manifest getManifest()>/$stack9	java.io.IOException
<org.springframework.boot.loader.jar.NestedJarFile: java.util.jar.Manifest getManifest()>/$methodtypeconstant0	java.lang.invoke.MethodType
<org.springframework.boot.loader.jar.NestedJarFile: java.util.jar.Manifest getManifest()>/$mhandleconstant0	java.lang.invoke.MethodHandle
<org.springframework.boot.loader.jar.NestedJarFile: java.util.jar.Manifest getManifest()>/$methodtypeconstant1	java.lang.invoke.MethodType
<org.springframework.boot.loader.jar.NestedJarFile: java.util.jar.Manifest getManifest()>/$classconstant0	java.lang.Class
<org.springframework.boot.loader.jar.NestedJarFile: java.util.Enumeration entries()>/@this	org.springframework.boot.loader.jar.NestedJarFile
<org.springframework.boot.loader.jar.NestedJarFile: java.util.Enumeration entries()>/this#_0	org.springframework.boot.loader.jar.NestedJarFile
<org.springframework.boot.loader.jar.NestedJarFile: java.util.Enumeration entries()>/$stack4	org.springframework.boot.loader.jar.NestedJarFile$JarEntriesEnumeration
<org.springframework.boot.loader.jar.NestedJarFile: java.util.Enumeration entries()>/$stack5	org.springframework.boot.loader.jar.NestedJarFileResources
<org.springframework.boot.loader.jar.NestedJarFile: java.util.Enumeration entries()>/$stack6	org.springframework.boot.loader.zip.ZipContent
<org.springframework.boot.loader.jar.NestedJarFile: java.util.Enumeration entries()>/$stack8	java.lang.Throwable
<org.springframework.boot.loader.jar.NestedJarFile: java.util.stream.Stream stream()>/@this	org.springframework.boot.loader.jar.NestedJarFile
<org.springframework.boot.loader.jar.NestedJarFile: java.util.stream.Stream stream()>/this#_0	org.springframework.boot.loader.jar.NestedJarFile
<org.springframework.boot.loader.jar.NestedJarFile: java.util.stream.Stream stream()>/$stack4	java.util.function.Function
<org.springframework.boot.loader.jar.NestedJarFile: java.util.stream.Stream stream()>/$stack5	java.util.stream.Stream
<org.springframework.boot.loader.jar.NestedJarFile: java.util.stream.Stream stream()>/$stack7	java.util.stream.Stream
<org.springframework.boot.loader.jar.NestedJarFile: java.util.stream.Stream stream()>/$stack8	java.lang.Throwable
<org.springframework.boot.loader.jar.NestedJarFile: java.util.stream.Stream stream()>/$methodtypeconstant0	java.lang.invoke.MethodType
<org.springframework.boot.loader.jar.NestedJarFile: java.util.stream.Stream stream()>/$mhandleconstant0	java.lang.invoke.MethodHandle
<org.springframework.boot.loader.jar.NestedJarFile: java.util.stream.Stream stream()>/$methodtypeconstant1	java.lang.invoke.MethodType
<org.springframework.boot.loader.jar.NestedJarFile: java.util.stream.Stream versionedStream()>/@this	org.springframework.boot.loader.jar.NestedJarFile
<org.springframework.boot.loader.jar.NestedJarFile: java.util.stream.Stream versionedStream()>/this#_0	org.springframework.boot.loader.jar.NestedJarFile
<org.springframework.boot.loader.jar.NestedJarFile: java.util.stream.Stream versionedStream()>/$stack4	java.util.function.Function
<org.springframework.boot.loader.jar.NestedJarFile: java.util.stream.Stream versionedStream()>/$stack5	java.util.stream.Stream
<org.springframework.boot.loader.jar.NestedJarFile: java.util.stream.Stream versionedStream()>/$stack6	java.util.function.Predicate
<org.springframework.boot.loader.jar.NestedJarFile: java.util.stream.Stream versionedStream()>/$stack7	java.util.stream.Stream
<org.springframework.boot.loader.jar.NestedJarFile: java.util.stream.Stream versionedStream()>/$stack8	java.util.stream.Stream
<org.springframework.boot.loader.jar.NestedJarFile: java.util.stream.Stream versionedStream()>/$stack9	java.util.function.Function
<org.springframework.boot.loader.jar.NestedJarFile: java.util.stream.Stream versionedStream()>/$stack10	java.util.stream.Stream
<org.springframework.boot.loader.jar.NestedJarFile: java.util.stream.Stream versionedStream()>/$stack11	java.util.function.Predicate
<org.springframework.boot.loader.jar.NestedJarFile: java.util.stream.Stream versionedStream()>/$stack12	java.util.stream.Stream
<org.springframework.boot.loader.jar.NestedJarFile: java.util.stream.Stream versionedStream()>/$stack14	java.util.stream.Stream
<org.springframework.boot.loader.jar.NestedJarFile: java.util.stream.Stream versionedStream()>/$stack15	java.lang.Throwable
<org.springframework.boot.loader.jar.NestedJarFile: java.util.stream.Stream versionedStream()>/$methodtypeconstant0	java.lang.invoke.MethodType
<org.springframework.boot.loader.jar.NestedJarFile: java.util.stream.Stream versionedStream()>/$mhandleconstant0	java.lang.invoke.MethodHandle
<org.springframework.boot.loader.jar.NestedJarFile: java.util.stream.Stream versionedStream()>/$methodtypeconstant1	java.lang.invoke.MethodType
<org.springframework.boot.loader.jar.NestedJarFile: java.util.stream.Stream versionedStream()>/$methodtypeconstant2	java.lang.invoke.MethodType
<org.springframework.boot.loader.jar.NestedJarFile: java.util.stream.Stream versionedStream()>/$mhandleconstant1	java.lang.invoke.MethodHandle
<org.springframework.boot.loader.jar.NestedJarFile: java.util.stream.Stream versionedStream()>/$methodtypeconstant3	java.lang.invoke.MethodType
<org.springframework.boot.loader.jar.NestedJarFile: java.util.stream.Stream versionedStream()>/$methodtypeconstant4	java.lang.invoke.MethodType
<org.springframework.boot.loader.jar.NestedJarFile: java.util.stream.Stream versionedStream()>/$mhandleconstant2	java.lang.invoke.MethodHandle
<org.springframework.boot.loader.jar.NestedJarFile: java.util.stream.Stream versionedStream()>/$methodtypeconstant5	java.lang.invoke.MethodType
<org.springframework.boot.loader.jar.NestedJarFile: java.util.stream.Stream versionedStream()>/$methodtypeconstant6	java.lang.invoke.MethodType
<org.springframework.boot.loader.jar.NestedJarFile: java.util.stream.Stream versionedStream()>/$mhandleconstant3	java.lang.invoke.MethodHandle
<org.springframework.boot.loader.jar.NestedJarFile: java.util.stream.Stream versionedStream()>/$methodtypeconstant7	java.lang.invoke.MethodType
<org.springframework.boot.loader.jar.NestedJarFile: java.util.stream.Stream streamContentEntries()>/@this	org.springframework.boot.loader.jar.NestedJarFile
<org.springframework.boot.loader.jar.NestedJarFile: java.util.stream.Stream streamContentEntries()>/$stack2	org.springframework.boot.loader.jar.NestedJarFile$ZipContentEntriesSpliterator
<org.springframework.boot.loader.jar.NestedJarFile: java.util.stream.Stream streamContentEntries()>/this#_0	org.springframework.boot.loader.jar.NestedJarFile
<org.springframework.boot.loader.jar.NestedJarFile: java.util.stream.Stream streamContentEntries()>/$stack3	org.springframework.boot.loader.jar.NestedJarFileResources
<org.springframework.boot.loader.jar.NestedJarFile: java.util.stream.Stream streamContentEntries()>/$stack4	org.springframework.boot.loader.zip.ZipContent
<org.springframework.boot.loader.jar.NestedJarFile: java.util.stream.Stream streamContentEntries()>/$stack5	java.util.stream.Stream
<org.springframework.boot.loader.jar.NestedJarFile: java.util.stream.Stream streamContentEntries()>/$numconstant0	int
<org.springframework.boot.loader.jar.NestedJarFile: java.lang.String getBaseName(org.springframework.boot.loader.zip.ZipContent$Entry)>/@this	org.springframework.boot.loader.jar.NestedJarFile
<org.springframework.boot.loader.jar.NestedJarFile: java.lang.String getBaseName(org.springframework.boot.loader.zip.ZipContent$Entry)>/@parameter0	org.springframework.boot.loader.zip.ZipContent$Entry
<org.springframework.boot.loader.jar.NestedJarFile: java.lang.String getBaseName(org.springframework.boot.loader.zip.ZipContent$Entry)>/contentEntry#_0	org.springframework.boot.loader.zip.ZipContent$Entry
<org.springframework.boot.loader.jar.NestedJarFile: java.lang.String getBaseName(org.springframework.boot.loader.zip.ZipContent$Entry)>/name#_206	java.lang.String
<org.springframework.boot.loader.jar.NestedJarFile: java.lang.String getBaseName(org.springframework.boot.loader.zip.ZipContent$Entry)>/$stack6	boolean
<org.springframework.boot.loader.jar.NestedJarFile: java.lang.String getBaseName(org.springframework.boot.loader.zip.ZipContent$Entry)>/$stack7	java.lang.String
<org.springframework.boot.loader.jar.NestedJarFile: java.lang.String getBaseName(org.springframework.boot.loader.zip.ZipContent$Entry)>/versionNumberStartIndex#_210	int
<org.springframework.boot.loader.jar.NestedJarFile: java.lang.String getBaseName(org.springframework.boot.loader.zip.ZipContent$Entry)>/$stack8	int
<org.springframework.boot.loader.jar.NestedJarFile: java.lang.String getBaseName(org.springframework.boot.loader.zip.ZipContent$Entry)>/$stack9	int
<org.springframework.boot.loader.jar.NestedJarFile: java.lang.String getBaseName(org.springframework.boot.loader.zip.ZipContent$Entry)>/this#_0	org.springframework.boot.loader.jar.NestedJarFile
<org.springframework.boot.loader.jar.NestedJarFile: java.lang.String getBaseName(org.springframework.boot.loader.zip.ZipContent$Entry)>/$stack10	int
<org.springframework.boot.loader.jar.NestedJarFile: java.lang.String getBaseName(org.springframework.boot.loader.zip.ZipContent$Entry)>/$stack11	int
<org.springframework.boot.loader.jar.NestedJarFile: java.lang.String getBaseName(org.springframework.boot.loader.zip.ZipContent$Entry)>/$stack12	java.lang.String
<org.springframework.boot.loader.jar.NestedJarFile: java.lang.String getBaseName(org.springframework.boot.loader.zip.ZipContent$Entry)>/$stack17	java.lang.NumberFormatException
<org.springframework.boot.loader.jar.NestedJarFile: java.lang.String getBaseName(org.springframework.boot.loader.zip.ZipContent$Entry)>/$stack14	int
<org.springframework.boot.loader.jar.NestedJarFile: java.lang.String getBaseName(org.springframework.boot.loader.zip.ZipContent$Entry)>/versionNumber#_216	int
<org.springframework.boot.loader.jar.NestedJarFile: java.lang.String getBaseName(org.springframework.boot.loader.zip.ZipContent$Entry)>/$i0	int
<org.springframework.boot.loader.jar.NestedJarFile: java.lang.String getBaseName(org.springframework.boot.loader.zip.ZipContent$Entry)>/$i1	int
<org.springframework.boot.loader.jar.NestedJarFile: java.lang.String getBaseName(org.springframework.boot.loader.zip.ZipContent$Entry)>/$i2	int
<org.springframework.boot.loader.jar.NestedJarFile: java.lang.String getBaseName(org.springframework.boot.loader.zip.ZipContent$Entry)>/$stack14_$$A_1	int
<org.springframework.boot.loader.jar.NestedJarFile: java.lang.String getBaseName(org.springframework.boot.loader.zip.ZipContent$Entry)>/$stack14_$$A_2	int
<org.springframework.boot.loader.jar.NestedJarFile: java.lang.String getBaseName(org.springframework.boot.loader.zip.ZipContent$Entry)>/$stringconstant0	java.lang.String
<org.springframework.boot.loader.jar.NestedJarFile: java.lang.String getBaseName(org.springframework.boot.loader.zip.ZipContent$Entry)>/$numconstant0	int
<org.springframework.boot.loader.jar.NestedJarFile: java.lang.String getBaseName(org.springframework.boot.loader.zip.ZipContent$Entry)>/$null0	java.lang.String
<org.springframework.boot.loader.jar.NestedJarFile: java.lang.String getBaseName(org.springframework.boot.loader.zip.ZipContent$Entry)>/$numconstant1	int
<org.springframework.boot.loader.jar.NestedJarFile: java.lang.String getBaseName(org.springframework.boot.loader.zip.ZipContent$Entry)>/$null1	java.lang.String
<org.springframework.boot.loader.jar.NestedJarFile: java.lang.String getBaseName(org.springframework.boot.loader.zip.ZipContent$Entry)>/$null2	java.lang.String
<org.springframework.boot.loader.jar.NestedJarFile: java.util.jar.JarEntry getJarEntry(java.lang.String)>/@this	org.springframework.boot.loader.jar.NestedJarFile
<org.springframework.boot.loader.jar.NestedJarFile: java.util.jar.JarEntry getJarEntry(java.lang.String)>/@parameter0	java.lang.String
<org.springframework.boot.loader.jar.NestedJarFile: java.util.jar.JarEntry getJarEntry(java.lang.String)>/this#_0	org.springframework.boot.loader.jar.NestedJarFile
<org.springframework.boot.loader.jar.NestedJarFile: java.util.jar.JarEntry getJarEntry(java.lang.String)>/name#_0	java.lang.String
<org.springframework.boot.loader.jar.NestedJarFile: java.util.jar.JarEntry getJarEntry(java.lang.String)>/$stack2	org.springframework.boot.loader.jar.NestedJarFile$NestedJarEntry
<org.springframework.boot.loader.jar.NestedJarFile: java.util.jar.JarEntry getEntry(java.lang.String)>/@this	org.springframework.boot.loader.jar.NestedJarFile
<org.springframework.boot.loader.jar.NestedJarFile: java.util.jar.JarEntry getEntry(java.lang.String)>/@parameter0	java.lang.String
<org.springframework.boot.loader.jar.NestedJarFile: java.util.jar.JarEntry getEntry(java.lang.String)>/this#_0	org.springframework.boot.loader.jar.NestedJarFile
<org.springframework.boot.loader.jar.NestedJarFile: java.util.jar.JarEntry getEntry(java.lang.String)>/name#_0	java.lang.String
<org.springframework.boot.loader.jar.NestedJarFile: java.util.jar.JarEntry getEntry(java.lang.String)>/$stack2	org.springframework.boot.loader.jar.NestedJarFile$NestedJarEntry
<org.springframework.boot.loader.jar.NestedJarFile: boolean hasEntry(java.lang.String)>/@this	org.springframework.boot.loader.jar.NestedJarFile
<org.springframework.boot.loader.jar.NestedJarFile: boolean hasEntry(java.lang.String)>/@parameter0	java.lang.String
<org.springframework.boot.loader.jar.NestedJarFile: boolean hasEntry(java.lang.String)>/this#_0	org.springframework.boot.loader.jar.NestedJarFile
<org.springframework.boot.loader.jar.NestedJarFile: boolean hasEntry(java.lang.String)>/lastEntry#_243	org.springframework.boot.loader.jar.NestedJarFile$NestedJarEntry
<org.springframework.boot.loader.jar.NestedJarFile: boolean hasEntry(java.lang.String)>/name#_0	java.lang.String
<org.springframework.boot.loader.jar.NestedJarFile: boolean hasEntry(java.lang.String)>/$stack7	org.springframework.boot.loader.jar.NestedJarFileResources
<org.springframework.boot.loader.jar.NestedJarFile: boolean hasEntry(java.lang.String)>/$stack8	org.springframework.boot.loader.zip.ZipContent
<org.springframework.boot.loader.jar.NestedJarFile: boolean hasEntry(java.lang.String)>/$stack10	boolean
<org.springframework.boot.loader.jar.NestedJarFile: boolean hasEntry(java.lang.String)>/$stack11	java.lang.String
<org.springframework.boot.loader.jar.NestedJarFile: boolean hasEntry(java.lang.String)>/$stack12	boolean
<org.springframework.boot.loader.jar.NestedJarFile: boolean hasEntry(java.lang.String)>/$stack15	org.springframework.boot.loader.zip.ZipContent$Entry
<org.springframework.boot.loader.jar.NestedJarFile: boolean hasEntry(java.lang.String)>/$stack17	java.lang.Throwable
<org.springframework.boot.loader.jar.NestedJarFile: boolean hasEntry(java.lang.String)>/$numconstant0	boolean
<org.springframework.boot.loader.jar.NestedJarFile: boolean hasEntry(java.lang.String)>/$numconstant1	boolean
<org.springframework.boot.loader.jar.NestedJarFile: boolean hasEntry(java.lang.String)>/$null0	java.lang.CharSequence
<org.springframework.boot.loader.jar.NestedJarFile: org.springframework.boot.loader.jar.NestedJarFile$NestedJarEntry getNestedJarEntry(java.lang.String)>/@this	org.springframework.boot.loader.jar.NestedJarFile
<org.springframework.boot.loader.jar.NestedJarFile: org.springframework.boot.loader.jar.NestedJarFile$NestedJarEntry getNestedJarEntry(java.lang.String)>/@parameter0	java.lang.String
<org.springframework.boot.loader.jar.NestedJarFile: org.springframework.boot.loader.jar.NestedJarFile$NestedJarEntry getNestedJarEntry(java.lang.String)>/name#_0	java.lang.String
<org.springframework.boot.loader.jar.NestedJarFile: org.springframework.boot.loader.jar.NestedJarFile$NestedJarEntry getNestedJarEntry(java.lang.String)>/this#_0	org.springframework.boot.loader.jar.NestedJarFile
<org.springframework.boot.loader.jar.NestedJarFile: org.springframework.boot.loader.jar.NestedJarFile$NestedJarEntry getNestedJarEntry(java.lang.String)>/lastEntry#_259	org.springframework.boot.loader.jar.NestedJarFile$NestedJarEntry
<org.springframework.boot.loader.jar.NestedJarFile: org.springframework.boot.loader.jar.NestedJarFile$NestedJarEntry getNestedJarEntry(java.lang.String)>/$stack6	org.springframework.boot.loader.jar.NestedJarFile$NestedJarEntry
<org.springframework.boot.loader.jar.NestedJarFile: org.springframework.boot.loader.jar.NestedJarFile$NestedJarEntry getNestedJarEntry(java.lang.String)>/$stack9	java.lang.String
<org.springframework.boot.loader.jar.NestedJarFile: org.springframework.boot.loader.jar.NestedJarFile$NestedJarEntry getNestedJarEntry(java.lang.String)>/$stack10	boolean
<org.springframework.boot.loader.jar.NestedJarFile: org.springframework.boot.loader.jar.NestedJarFile$NestedJarEntry getNestedJarEntry(java.lang.String)>/$stack13	org.springframework.boot.loader.zip.ZipContent$Entry
<org.springframework.boot.loader.jar.NestedJarFile: org.springframework.boot.loader.jar.NestedJarFile$NestedJarEntry getNestedJarEntry(java.lang.String)>/$stack7	org.springframework.boot.loader.zip.ZipContent$Entry
<org.springframework.boot.loader.jar.NestedJarFile: org.springframework.boot.loader.jar.NestedJarFile$NestedJarEntry getNestedJarEntry(java.lang.String)>/$stack7_$$A_1	org.springframework.boot.loader.zip.ZipContent$Entry
<org.springframework.boot.loader.jar.NestedJarFile: org.springframework.boot.loader.jar.NestedJarFile$NestedJarEntry getNestedJarEntry(java.lang.String)>/$stack7_$$A_2	org.springframework.boot.loader.zip.ZipContent$Entry
<org.springframework.boot.loader.jar.NestedJarFile: org.springframework.boot.loader.jar.NestedJarFile$NestedJarEntry getNestedJarEntry(java.lang.String)>/$stringconstant0	java.lang.String
<org.springframework.boot.loader.jar.NestedJarFile: org.springframework.boot.loader.jar.NestedJarFile$NestedJarEntry getNestedJarEntry(java.lang.String)>/$null0	java.lang.String
<org.springframework.boot.loader.jar.NestedJarFile: org.springframework.boot.loader.jar.NestedJarFile$NestedJarEntry getNestedJarEntry(java.lang.String)>/$null1	org.springframework.boot.loader.jar.NestedJarFile$NestedJarEntry
<org.springframework.boot.loader.jar.NestedJarFile: org.springframework.boot.loader.zip.ZipContent$Entry getVersionedContentEntry(java.lang.String)>/@this	org.springframework.boot.loader.jar.NestedJarFile
<org.springframework.boot.loader.jar.NestedJarFile: org.springframework.boot.loader.zip.ZipContent$Entry getVersionedContentEntry(java.lang.String)>/@parameter0	java.lang.String
<org.springframework.boot.loader.jar.NestedJarFile: org.springframework.boot.loader.zip.ZipContent$Entry getVersionedContentEntry(java.lang.String)>/this#_0	org.springframework.boot.loader.jar.NestedJarFile
<org.springframework.boot.loader.jar.NestedJarFile: org.springframework.boot.loader.zip.ZipContent$Entry getVersionedContentEntry(java.lang.String)>/$stack7	int
<org.springframework.boot.loader.jar.NestedJarFile: org.springframework.boot.loader.zip.ZipContent$Entry getVersionedContentEntry(java.lang.String)>/$stack8	int
<org.springframework.boot.loader.jar.NestedJarFile: org.springframework.boot.loader.zip.ZipContent$Entry getVersionedContentEntry(java.lang.String)>/name#_0	java.lang.String
<org.springframework.boot.loader.jar.NestedJarFile: org.springframework.boot.loader.zip.ZipContent$Entry getVersionedContentEntry(java.lang.String)>/$stack9	boolean
<org.springframework.boot.loader.jar.NestedJarFile: org.springframework.boot.loader.zip.ZipContent$Entry getVersionedContentEntry(java.lang.String)>/$stack11	org.springframework.boot.loader.jar.ManifestInfo
<org.springframework.boot.loader.jar.NestedJarFile: org.springframework.boot.loader.zip.ZipContent$Entry getVersionedContentEntry(java.lang.String)>/$stack12	boolean
<org.springframework.boot.loader.jar.NestedJarFile: org.springframework.boot.loader.zip.ZipContent$Entry getVersionedContentEntry(java.lang.String)>/metaInfVersionsInfo#_279	org.springframework.boot.loader.jar.MetaInfVersionsInfo
<org.springframework.boot.loader.jar.NestedJarFile: org.springframework.boot.loader.zip.ZipContent$Entry getVersionedContentEntry(java.lang.String)>/versions#_280	int[]
<org.springframework.boot.loader.jar.NestedJarFile: org.springframework.boot.loader.zip.ZipContent$Entry getVersionedContentEntry(java.lang.String)>/directories#_281	java.lang.String[]
<org.springframework.boot.loader.jar.NestedJarFile: org.springframework.boot.loader.zip.ZipContent$Entry getVersionedContentEntry(java.lang.String)>/$stack13	int
<org.springframework.boot.loader.jar.NestedJarFile: org.springframework.boot.loader.zip.ZipContent$Entry getVersionedContentEntry(java.lang.String)>/$stack14	int
<org.springframework.boot.loader.jar.NestedJarFile: org.springframework.boot.loader.zip.ZipContent$Entry getVersionedContentEntry(java.lang.String)>/$stack15	int
<org.springframework.boot.loader.jar.NestedJarFile: org.springframework.boot.loader.zip.ZipContent$Entry getVersionedContentEntry(java.lang.String)>/$stack17	java.lang.String
<org.springframework.boot.loader.jar.NestedJarFile: org.springframework.boot.loader.zip.ZipContent$Entry getVersionedContentEntry(java.lang.String)>/entry#_284	org.springframework.boot.loader.zip.ZipContent$Entry
<org.springframework.boot.loader.jar.NestedJarFile: org.springframework.boot.loader.zip.ZipContent$Entry getVersionedContentEntry(java.lang.String)>/i#_282	int
<org.springframework.boot.loader.jar.NestedJarFile: org.springframework.boot.loader.zip.ZipContent$Entry getVersionedContentEntry(java.lang.String)>/$i0	int
<org.springframework.boot.loader.jar.NestedJarFile: org.springframework.boot.loader.zip.ZipContent$Entry getVersionedContentEntry(java.lang.String)>/i_$$A_1#_283	int
<org.springframework.boot.loader.jar.NestedJarFile: org.springframework.boot.loader.zip.ZipContent$Entry getVersionedContentEntry(java.lang.String)>/i_$$A_2#_282	int
<org.springframework.boot.loader.jar.NestedJarFile: org.springframework.boot.loader.zip.ZipContent$Entry getVersionedContentEntry(java.lang.String)>/$stringconstant0	java.lang.String
<org.springframework.boot.loader.jar.NestedJarFile: org.springframework.boot.loader.zip.ZipContent$Entry getVersionedContentEntry(java.lang.String)>/$null0	org.springframework.boot.loader.zip.ZipContent$Entry
<org.springframework.boot.loader.jar.NestedJarFile: org.springframework.boot.loader.zip.ZipContent$Entry getVersionedContentEntry(java.lang.String)>/$null1	org.springframework.boot.loader.zip.ZipContent$Entry
<org.springframework.boot.loader.jar.NestedJarFile: org.springframework.boot.loader.zip.ZipContent$Entry getContentEntry(java.lang.String,java.lang.String)>/@this	org.springframework.boot.loader.jar.NestedJarFile
<org.springframework.boot.loader.jar.NestedJarFile: org.springframework.boot.loader.zip.ZipContent$Entry getContentEntry(java.lang.String,java.lang.String)>/@parameter0	java.lang.String
<org.springframework.boot.loader.jar.NestedJarFile: org.springframework.boot.loader.zip.ZipContent$Entry getContentEntry(java.lang.String,java.lang.String)>/@parameter1	java.lang.String
<org.springframework.boot.loader.jar.NestedJarFile: org.springframework.boot.loader.zip.ZipContent$Entry getContentEntry(java.lang.String,java.lang.String)>/this#_0	org.springframework.boot.loader.jar.NestedJarFile
<org.springframework.boot.loader.jar.NestedJarFile: org.springframework.boot.loader.zip.ZipContent$Entry getContentEntry(java.lang.String,java.lang.String)>/$stack6	org.springframework.boot.loader.jar.NestedJarFileResources
<org.springframework.boot.loader.jar.NestedJarFile: org.springframework.boot.loader.zip.ZipContent$Entry getContentEntry(java.lang.String,java.lang.String)>/namePrefix#_0	java.lang.String
<org.springframework.boot.loader.jar.NestedJarFile: org.springframework.boot.loader.zip.ZipContent$Entry getContentEntry(java.lang.String,java.lang.String)>/name#_0	java.lang.String
<org.springframework.boot.loader.jar.NestedJarFile: org.springframework.boot.loader.zip.ZipContent$Entry getContentEntry(java.lang.String,java.lang.String)>/$stack7	org.springframework.boot.loader.zip.ZipContent
<org.springframework.boot.loader.jar.NestedJarFile: org.springframework.boot.loader.zip.ZipContent$Entry getContentEntry(java.lang.String,java.lang.String)>/$stack9	org.springframework.boot.loader.zip.ZipContent$Entry
<org.springframework.boot.loader.jar.NestedJarFile: org.springframework.boot.loader.zip.ZipContent$Entry getContentEntry(java.lang.String,java.lang.String)>/$stack10	java.lang.Throwable
<org.springframework.boot.loader.jar.NestedJarFile: org.springframework.boot.loader.jar.ManifestInfo getManifestInfo()>/@this	org.springframework.boot.loader.jar.NestedJarFile
<org.springframework.boot.loader.jar.NestedJarFile: org.springframework.boot.loader.jar.ManifestInfo getManifestInfo()>/this#_0	org.springframework.boot.loader.jar.NestedJarFile
<org.springframework.boot.loader.jar.NestedJarFile: org.springframework.boot.loader.jar.ManifestInfo getManifestInfo()>/$stack5	org.springframework.boot.loader.jar.NestedJarFileResources
<org.springframework.boot.loader.jar.NestedJarFile: org.springframework.boot.loader.jar.ManifestInfo getManifestInfo()>/$stack6	java.util.function.Function
<org.springframework.boot.loader.jar.NestedJarFile: org.springframework.boot.loader.jar.ManifestInfo getManifestInfo()>/$stack7	org.springframework.boot.loader.zip.ZipContent
<org.springframework.boot.loader.jar.NestedJarFile: org.springframework.boot.loader.jar.ManifestInfo getManifestInfo()>/$stack8	java.lang.Object
<org.springframework.boot.loader.jar.NestedJarFile: org.springframework.boot.loader.jar.ManifestInfo getManifestInfo()>/$stack10	java.lang.Throwable
<org.springframework.boot.loader.jar.NestedJarFile: org.springframework.boot.loader.jar.ManifestInfo getManifestInfo()>/manifestInfo#_301	org.springframework.boot.loader.jar.ManifestInfo
<org.springframework.boot.loader.jar.NestedJarFile: org.springframework.boot.loader.jar.ManifestInfo getManifestInfo()>/manifestInfo_$$A_1#_307	org.springframework.boot.loader.jar.ManifestInfo
<org.springframework.boot.loader.jar.NestedJarFile: org.springframework.boot.loader.jar.ManifestInfo getManifestInfo()>/manifestInfo_$$A_2#_304	org.springframework.boot.loader.jar.ManifestInfo
<org.springframework.boot.loader.jar.NestedJarFile: org.springframework.boot.loader.jar.ManifestInfo getManifestInfo()>/$methodtypeconstant0	java.lang.invoke.MethodType
<org.springframework.boot.loader.jar.NestedJarFile: org.springframework.boot.loader.jar.ManifestInfo getManifestInfo()>/$mhandleconstant0	java.lang.invoke.MethodHandle
<org.springframework.boot.loader.jar.NestedJarFile: org.springframework.boot.loader.jar.ManifestInfo getManifestInfo()>/$methodtypeconstant1	java.lang.invoke.MethodType
<org.springframework.boot.loader.jar.NestedJarFile: org.springframework.boot.loader.jar.ManifestInfo getManifestInfo()>/$classconstant0	java.lang.Class
<org.springframework.boot.loader.jar.NestedJarFile: org.springframework.boot.loader.jar.ManifestInfo getManifestInfo(org.springframework.boot.loader.zip.ZipContent)>/@this	org.springframework.boot.loader.jar.NestedJarFile
<org.springframework.boot.loader.jar.NestedJarFile: org.springframework.boot.loader.jar.ManifestInfo getManifestInfo(org.springframework.boot.loader.zip.ZipContent)>/@parameter0	org.springframework.boot.loader.zip.ZipContent
<org.springframework.boot.loader.jar.NestedJarFile: org.springframework.boot.loader.jar.ManifestInfo getManifestInfo(org.springframework.boot.loader.zip.ZipContent)>/zipContent#_0	org.springframework.boot.loader.zip.ZipContent
<org.springframework.boot.loader.jar.NestedJarFile: org.springframework.boot.loader.jar.ManifestInfo getManifestInfo(org.springframework.boot.loader.zip.ZipContent)>/contentEntry#_314	org.springframework.boot.loader.zip.ZipContent$Entry
<org.springframework.boot.loader.jar.NestedJarFile: org.springframework.boot.loader.jar.ManifestInfo getManifestInfo(org.springframework.boot.loader.zip.ZipContent)>/this#_0	org.springframework.boot.loader.jar.NestedJarFile
<org.springframework.boot.loader.jar.NestedJarFile: org.springframework.boot.loader.jar.ManifestInfo getManifestInfo(org.springframework.boot.loader.zip.ZipContent)>/$stack6	java.util.jar.Manifest
<org.springframework.boot.loader.jar.NestedJarFile: org.springframework.boot.loader.jar.ManifestInfo getManifestInfo(org.springframework.boot.loader.zip.ZipContent)>/$stack7	org.springframework.boot.loader.jar.ManifestInfo
<org.springframework.boot.loader.jar.NestedJarFile: org.springframework.boot.loader.jar.ManifestInfo getManifestInfo(org.springframework.boot.loader.zip.ZipContent)>/$stack9	org.springframework.boot.loader.jar.ManifestInfo
<org.springframework.boot.loader.jar.NestedJarFile: org.springframework.boot.loader.jar.ManifestInfo getManifestInfo(org.springframework.boot.loader.zip.ZipContent)>/$stack10	java.io.IOException
<org.springframework.boot.loader.jar.NestedJarFile: org.springframework.boot.loader.jar.ManifestInfo getManifestInfo(org.springframework.boot.loader.zip.ZipContent)>/$stack11	java.io.UncheckedIOException
<org.springframework.boot.loader.jar.NestedJarFile: org.springframework.boot.loader.jar.ManifestInfo getManifestInfo(org.springframework.boot.loader.zip.ZipContent)>/$stack12	java.lang.Throwable
<org.springframework.boot.loader.jar.NestedJarFile: org.springframework.boot.loader.jar.ManifestInfo getManifestInfo(org.springframework.boot.loader.zip.ZipContent)>/$stack13	java.lang.Throwable
<org.springframework.boot.loader.jar.NestedJarFile: org.springframework.boot.loader.jar.ManifestInfo getManifestInfo(org.springframework.boot.loader.zip.ZipContent)>/inputStream#_319	java.io.InputStream
<org.springframework.boot.loader.jar.NestedJarFile: org.springframework.boot.loader.jar.ManifestInfo getManifestInfo(org.springframework.boot.loader.zip.ZipContent)>/$stringconstant0	java.lang.String
<org.springframework.boot.loader.jar.NestedJarFile: org.springframework.boot.loader.jar.MetaInfVersionsInfo getMetaInfVersionsInfo()>/@this	org.springframework.boot.loader.jar.NestedJarFile
<org.springframework.boot.loader.jar.NestedJarFile: org.springframework.boot.loader.jar.MetaInfVersionsInfo getMetaInfVersionsInfo()>/this#_0	org.springframework.boot.loader.jar.NestedJarFile
<org.springframework.boot.loader.jar.NestedJarFile: org.springframework.boot.loader.jar.MetaInfVersionsInfo getMetaInfVersionsInfo()>/$stack5	org.springframework.boot.loader.jar.NestedJarFileResources
<org.springframework.boot.loader.jar.NestedJarFile: org.springframework.boot.loader.jar.MetaInfVersionsInfo getMetaInfVersionsInfo()>/$stack6	java.util.function.Function
<org.springframework.boot.loader.jar.NestedJarFile: org.springframework.boot.loader.jar.MetaInfVersionsInfo getMetaInfVersionsInfo()>/$stack7	org.springframework.boot.loader.zip.ZipContent
<org.springframework.boot.loader.jar.NestedJarFile: org.springframework.boot.loader.jar.MetaInfVersionsInfo getMetaInfVersionsInfo()>/$stack8	java.lang.Object
<org.springframework.boot.loader.jar.NestedJarFile: org.springframework.boot.loader.jar.MetaInfVersionsInfo getMetaInfVersionsInfo()>/$stack10	java.lang.Throwable
<org.springframework.boot.loader.jar.NestedJarFile: org.springframework.boot.loader.jar.MetaInfVersionsInfo getMetaInfVersionsInfo()>/metaInfVersionsInfo#_330	org.springframework.boot.loader.jar.MetaInfVersionsInfo
<org.springframework.boot.loader.jar.NestedJarFile: org.springframework.boot.loader.jar.MetaInfVersionsInfo getMetaInfVersionsInfo()>/metaInfVersionsInfo_$$A_1#_337	org.springframework.boot.loader.jar.MetaInfVersionsInfo
<org.springframework.boot.loader.jar.NestedJarFile: org.springframework.boot.loader.jar.MetaInfVersionsInfo getMetaInfVersionsInfo()>/metaInfVersionsInfo_$$A_2#_333	org.springframework.boot.loader.jar.MetaInfVersionsInfo
<org.springframework.boot.loader.jar.NestedJarFile: org.springframework.boot.loader.jar.MetaInfVersionsInfo getMetaInfVersionsInfo()>/$methodtypeconstant0	java.lang.invoke.MethodType
<org.springframework.boot.loader.jar.NestedJarFile: org.springframework.boot.loader.jar.MetaInfVersionsInfo getMetaInfVersionsInfo()>/$mhandleconstant0	java.lang.invoke.MethodHandle
<org.springframework.boot.loader.jar.NestedJarFile: org.springframework.boot.loader.jar.MetaInfVersionsInfo getMetaInfVersionsInfo()>/$methodtypeconstant1	java.lang.invoke.MethodType
<org.springframework.boot.loader.jar.NestedJarFile: org.springframework.boot.loader.jar.MetaInfVersionsInfo getMetaInfVersionsInfo()>/$classconstant0	java.lang.Class
<org.springframework.boot.loader.jar.NestedJarFile: java.io.InputStream getInputStream(java.util.zip.ZipEntry)>/@this	org.springframework.boot.loader.jar.NestedJarFile
<org.springframework.boot.loader.jar.NestedJarFile: java.io.InputStream getInputStream(java.util.zip.ZipEntry)>/@parameter0	java.util.zip.ZipEntry
<org.springframework.boot.loader.jar.NestedJarFile: java.io.InputStream getInputStream(java.util.zip.ZipEntry)>/entry#_0	java.util.zip.ZipEntry
<org.springframework.boot.loader.jar.NestedJarFile: java.io.InputStream getInputStream(java.util.zip.ZipEntry)>/$stack4	boolean
<org.springframework.boot.loader.jar.NestedJarFile: java.io.InputStream getInputStream(java.util.zip.ZipEntry)>/this#_0	org.springframework.boot.loader.jar.NestedJarFile
<org.springframework.boot.loader.jar.NestedJarFile: java.io.InputStream getInputStream(java.util.zip.ZipEntry)>/$stack5	java.lang.String
<org.springframework.boot.loader.jar.NestedJarFile: java.io.InputStream getInputStream(java.util.zip.ZipEntry)>/$stack6	org.springframework.boot.loader.jar.NestedJarFile$NestedJarEntry
<org.springframework.boot.loader.jar.NestedJarFile: java.io.InputStream getInputStream(java.util.zip.ZipEntry)>/$stack7	org.springframework.boot.loader.zip.ZipContent$Entry
<org.springframework.boot.loader.jar.NestedJarFile: java.io.InputStream getInputStream(java.util.zip.ZipEntry)>/$stack8	java.io.InputStream
<org.springframework.boot.loader.jar.NestedJarFile: java.io.InputStream getInputStream(java.util.zip.ZipEntry)>/nestedJarEntry#_346	org.springframework.boot.loader.jar.NestedJarFile$NestedJarEntry
<org.springframework.boot.loader.jar.NestedJarFile: java.io.InputStream getInputStream(java.util.zip.ZipEntry)>/$stack9	boolean
<org.springframework.boot.loader.jar.NestedJarFile: java.io.InputStream getInputStream(java.util.zip.ZipEntry)>/$stack13	org.springframework.boot.loader.zip.ZipContent$Entry
<org.springframework.boot.loader.jar.NestedJarFile: java.io.InputStream getInputStream(java.util.zip.ZipEntry)>/$stack14	java.io.InputStream
<org.springframework.boot.loader.jar.NestedJarFile: java.io.InputStream getInputStream(java.util.zip.ZipEntry)>/$stringconstant0	java.lang.String
<org.springframework.boot.loader.jar.NestedJarFile: java.io.InputStream getInputStream(org.springframework.boot.loader.zip.ZipContent$Entry)>/@this	org.springframework.boot.loader.jar.NestedJarFile
<org.springframework.boot.loader.jar.NestedJarFile: java.io.InputStream getInputStream(org.springframework.boot.loader.zip.ZipContent$Entry)>/@parameter0	org.springframework.boot.loader.zip.ZipContent$Entry
<org.springframework.boot.loader.jar.NestedJarFile: java.io.InputStream getInputStream(org.springframework.boot.loader.zip.ZipContent$Entry)>/contentEntry#_0	org.springframework.boot.loader.zip.ZipContent$Entry
<org.springframework.boot.loader.jar.NestedJarFile: java.io.InputStream getInputStream(org.springframework.boot.loader.zip.ZipContent$Entry)>/compression#_353	int
<org.springframework.boot.loader.jar.NestedJarFile: java.io.InputStream getInputStream(org.springframework.boot.loader.zip.ZipContent$Entry)>/this#_0	org.springframework.boot.loader.jar.NestedJarFile
<org.springframework.boot.loader.jar.NestedJarFile: java.io.InputStream getInputStream(org.springframework.boot.loader.zip.ZipContent$Entry)>/$stack8	org.springframework.boot.loader.jar.NestedJarFile$JarEntryInputStream
<org.springframework.boot.loader.jar.NestedJarFile: java.io.InputStream getInputStream(org.springframework.boot.loader.zip.ZipContent$Entry)>/$stack9	org.springframework.boot.loader.jar.NestedJarFileResources
<org.springframework.boot.loader.jar.NestedJarFile: java.io.InputStream getInputStream(org.springframework.boot.loader.zip.ZipContent$Entry)>/$stack11	org.springframework.boot.loader.jar.NestedJarFile$JarEntryInflaterInputStream
<org.springframework.boot.loader.jar.NestedJarFile: java.io.InputStream getInputStream(org.springframework.boot.loader.zip.ZipContent$Entry)>/$stack12	org.springframework.boot.loader.jar.NestedJarFileResources
<org.springframework.boot.loader.jar.NestedJarFile: java.io.InputStream getInputStream(org.springframework.boot.loader.zip.ZipContent$Entry)>/$stack13	org.springframework.boot.loader.jar.NestedJarFile$JarEntryInputStream
<org.springframework.boot.loader.jar.NestedJarFile: java.io.InputStream getInputStream(org.springframework.boot.loader.zip.ZipContent$Entry)>/$stack22	java.util.zip.ZipException
<org.springframework.boot.loader.jar.NestedJarFile: java.io.InputStream getInputStream(org.springframework.boot.loader.zip.ZipContent$Entry)>/$stack23	java.lang.Throwable
<org.springframework.boot.loader.jar.NestedJarFile: java.io.InputStream getInputStream(org.springframework.boot.loader.zip.ZipContent$Entry)>/$stack25	java.lang.RuntimeException
<org.springframework.boot.loader.jar.NestedJarFile: java.io.InputStream getInputStream(org.springframework.boot.loader.zip.ZipContent$Entry)>/inputStream#_359	java.io.InputStream
<org.springframework.boot.loader.jar.NestedJarFile: java.io.InputStream getInputStream(org.springframework.boot.loader.zip.ZipContent$Entry)>/inputStream_$$A_1#_362	java.io.InputStream
<org.springframework.boot.loader.jar.NestedJarFile: java.io.InputStream getInputStream(org.springframework.boot.loader.zip.ZipContent$Entry)>/inputStream_$$A_2#_363	java.io.InputStream
<org.springframework.boot.loader.jar.NestedJarFile: java.io.InputStream getInputStream(org.springframework.boot.loader.zip.ZipContent$Entry)>/inputStream_$$A_3#_372	java.io.InputStream
<org.springframework.boot.loader.jar.NestedJarFile: java.io.InputStream getInputStream(org.springframework.boot.loader.zip.ZipContent$Entry)>/inputStream_$$A_4#_356	java.io.InputStream
<org.springframework.boot.loader.jar.NestedJarFile: java.io.InputStream getInputStream(org.springframework.boot.loader.zip.ZipContent$Entry)>/$stringconstant0	java.lang.String
<org.springframework.boot.loader.jar.NestedJarFile: java.lang.String getComment()>/@this	org.springframework.boot.loader.jar.NestedJarFile
<org.springframework.boot.loader.jar.NestedJarFile: java.lang.String getComment()>/this#_0	org.springframework.boot.loader.jar.NestedJarFile
<org.springframework.boot.loader.jar.NestedJarFile: java.lang.String getComment()>/$stack4	org.springframework.boot.loader.jar.NestedJarFileResources
<org.springframework.boot.loader.jar.NestedJarFile: java.lang.String getComment()>/$stack5	org.springframework.boot.loader.zip.ZipContent
<org.springframework.boot.loader.jar.NestedJarFile: java.lang.String getComment()>/$stack7	java.lang.String
<org.springframework.boot.loader.jar.NestedJarFile: java.lang.String getComment()>/$stack8	java.lang.Throwable
<org.springframework.boot.loader.jar.NestedJarFile: int size()>/@this	org.springframework.boot.loader.jar.NestedJarFile
<org.springframework.boot.loader.jar.NestedJarFile: int size()>/this#_0	org.springframework.boot.loader.jar.NestedJarFile
<org.springframework.boot.loader.jar.NestedJarFile: int size()>/$stack4	org.springframework.boot.loader.jar.NestedJarFileResources
<org.springframework.boot.loader.jar.NestedJarFile: int size()>/$stack5	org.springframework.boot.loader.zip.ZipContent
<org.springframework.boot.loader.jar.NestedJarFile: int size()>/$stack7	int
<org.springframework.boot.loader.jar.NestedJarFile: int size()>/$stack8	java.lang.Throwable
<org.springframework.boot.loader.jar.NestedJarFile: void close()>/@this	org.springframework.boot.loader.jar.NestedJarFile
<org.springframework.boot.loader.jar.NestedJarFile: void close()>/this#_0	org.springframework.boot.loader.jar.NestedJarFile
<org.springframework.boot.loader.jar.NestedJarFile: void close()>/$stack4	boolean
<org.springframework.boot.loader.jar.NestedJarFile: void close()>/$stack6	java.lang.ref.Cleaner$Cleanable
<org.springframework.boot.loader.jar.NestedJarFile: void close()>/$stack8	java.lang.Throwable
<org.springframework.boot.loader.jar.NestedJarFile: void close()>/$stack10	java.io.UncheckedIOException
<org.springframework.boot.loader.jar.NestedJarFile: void close()>/$stack11	java.io.IOException
<org.springframework.boot.loader.jar.NestedJarFile: void close()>/$numconstant0	boolean
<org.springframework.boot.loader.jar.NestedJarFile: java.lang.String getName()>/@this	org.springframework.boot.loader.jar.NestedJarFile
<org.springframework.boot.loader.jar.NestedJarFile: java.lang.String getName()>/this#_0	org.springframework.boot.loader.jar.NestedJarFile
<org.springframework.boot.loader.jar.NestedJarFile: java.lang.String getName()>/$stack1	java.lang.String
<org.springframework.boot.loader.jar.NestedJarFile: void ensureOpen()>/@this	org.springframework.boot.loader.jar.NestedJarFile
<org.springframework.boot.loader.jar.NestedJarFile: void ensureOpen()>/this#_0	org.springframework.boot.loader.jar.NestedJarFile
<org.springframework.boot.loader.jar.NestedJarFile: void ensureOpen()>/$stack1	boolean
<org.springframework.boot.loader.jar.NestedJarFile: void ensureOpen()>/$stack2	org.springframework.boot.loader.jar.NestedJarFileResources
<org.springframework.boot.loader.jar.NestedJarFile: void ensureOpen()>/$stack3	org.springframework.boot.loader.zip.ZipContent
<org.springframework.boot.loader.jar.NestedJarFile: void ensureOpen()>/$stack4	java.lang.IllegalStateException
<org.springframework.boot.loader.jar.NestedJarFile: void ensureOpen()>/$stack5	java.lang.IllegalStateException
<org.springframework.boot.loader.jar.NestedJarFile: void ensureOpen()>/$stringconstant0	java.lang.String
<org.springframework.boot.loader.jar.NestedJarFile: void ensureOpen()>/$stringconstant1	java.lang.String
<org.springframework.boot.loader.jar.NestedJarFile: void clearCache()>/@this	org.springframework.boot.loader.jar.NestedJarFile
<org.springframework.boot.loader.jar.NestedJarFile: void clearCache()>/this#_0	org.springframework.boot.loader.jar.NestedJarFile
<org.springframework.boot.loader.jar.NestedJarFile: void clearCache()>/$stack5	java.lang.Throwable
<org.springframework.boot.loader.jar.NestedJarFile: void clearCache()>/$null0	org.springframework.boot.loader.jar.NestedJarFile$NestedJarEntry
<org.springframework.boot.loader.jar.NestedJarFile: java.util.zip.ZipEntry getEntry(java.lang.String)>/@this	org.springframework.boot.loader.jar.NestedJarFile
<org.springframework.boot.loader.jar.NestedJarFile: java.util.zip.ZipEntry getEntry(java.lang.String)>/@parameter0	java.lang.String
<org.springframework.boot.loader.jar.NestedJarFile: java.util.zip.ZipEntry getEntry(java.lang.String)>/this#_0	org.springframework.boot.loader.jar.NestedJarFile
<org.springframework.boot.loader.jar.NestedJarFile: java.util.zip.ZipEntry getEntry(java.lang.String)>/l1#_0	java.lang.String
<org.springframework.boot.loader.jar.NestedJarFile: java.util.zip.ZipEntry getEntry(java.lang.String)>/$stack2	java.util.jar.JarEntry
<org.springframework.boot.loader.jar.NestedJarFile: java.util.jar.JarEntry lambda$stream$0(org.springframework.boot.loader.zip.ZipContent$Entry)>/@this	org.springframework.boot.loader.jar.NestedJarFile
<org.springframework.boot.loader.jar.NestedJarFile: java.util.jar.JarEntry lambda$stream$0(org.springframework.boot.loader.zip.ZipContent$Entry)>/@parameter0	org.springframework.boot.loader.zip.ZipContent$Entry
<org.springframework.boot.loader.jar.NestedJarFile: java.util.jar.JarEntry lambda$stream$0(org.springframework.boot.loader.zip.ZipContent$Entry)>/$stack2	org.springframework.boot.loader.jar.NestedJarFile$NestedJarEntry
<org.springframework.boot.loader.jar.NestedJarFile: java.util.jar.JarEntry lambda$stream$0(org.springframework.boot.loader.zip.ZipContent$Entry)>/this#_0	org.springframework.boot.loader.jar.NestedJarFile
<org.springframework.boot.loader.jar.NestedJarFile: java.util.jar.JarEntry lambda$stream$0(org.springframework.boot.loader.zip.ZipContent$Entry)>/x$0#_0	org.springframework.boot.loader.zip.ZipContent$Entry
<org.springframework.boot.loader.jar.NestedJarFile: void <clinit>()>/$stack0	java.lang.Runtime$Version
<org.springframework.boot.loader.jar.NestedJarFile: void <clinit>()>/$stack1	int
<org.springframework.boot.loader.jar.NestedJarFile: void <clinit>()>/$stack2	org.springframework.boot.loader.log.DebugLogger
<org.springframework.boot.loader.jar.NestedJarFile: void <clinit>()>/$classconstant0	java.lang.Class
<org.springframework.boot.loader.jar.NestedJarFile$JarEntriesEnumeration: void <init>(org.springframework.boot.loader.jar.NestedJarFile,org.springframework.boot.loader.zip.ZipContent)>/@this	org.springframework.boot.loader.jar.NestedJarFile$JarEntriesEnumeration
<org.springframework.boot.loader.jar.NestedJarFile$JarEntriesEnumeration: void <init>(org.springframework.boot.loader.jar.NestedJarFile,org.springframework.boot.loader.zip.ZipContent)>/@parameter0	org.springframework.boot.loader.jar.NestedJarFile
<org.springframework.boot.loader.jar.NestedJarFile$JarEntriesEnumeration: void <init>(org.springframework.boot.loader.jar.NestedJarFile,org.springframework.boot.loader.zip.ZipContent)>/@parameter1	org.springframework.boot.loader.zip.ZipContent
<org.springframework.boot.loader.jar.NestedJarFile$JarEntriesEnumeration: void <init>(org.springframework.boot.loader.jar.NestedJarFile,org.springframework.boot.loader.zip.ZipContent)>/this#_0	org.springframework.boot.loader.jar.NestedJarFile$JarEntriesEnumeration
<org.springframework.boot.loader.jar.NestedJarFile$JarEntriesEnumeration: void <init>(org.springframework.boot.loader.jar.NestedJarFile,org.springframework.boot.loader.zip.ZipContent)>/l1#_0	org.springframework.boot.loader.jar.NestedJarFile
<org.springframework.boot.loader.jar.NestedJarFile$JarEntriesEnumeration: void <init>(org.springframework.boot.loader.jar.NestedJarFile,org.springframework.boot.loader.zip.ZipContent)>/zipContent#_0	org.springframework.boot.loader.zip.ZipContent
<org.springframework.boot.loader.jar.NestedJarFile$JarEntriesEnumeration: boolean hasMoreElements()>/@this	org.springframework.boot.loader.jar.NestedJarFile$JarEntriesEnumeration
<org.springframework.boot.loader.jar.NestedJarFile$JarEntriesEnumeration: boolean hasMoreElements()>/this#_0	org.springframework.boot.loader.jar.NestedJarFile$JarEntriesEnumeration
<org.springframework.boot.loader.jar.NestedJarFile$JarEntriesEnumeration: boolean hasMoreElements()>/$stack1	org.springframework.boot.loader.zip.ZipContent
<org.springframework.boot.loader.jar.NestedJarFile$JarEntriesEnumeration: boolean hasMoreElements()>/$stack2	int
<org.springframework.boot.loader.jar.NestedJarFile$JarEntriesEnumeration: boolean hasMoreElements()>/$stack3	int
<org.springframework.boot.loader.jar.NestedJarFile$JarEntriesEnumeration: boolean hasMoreElements()>/$stack4	boolean
<org.springframework.boot.loader.jar.NestedJarFile$JarEntriesEnumeration: boolean hasMoreElements()>/$stack4_$$A_1	boolean
<org.springframework.boot.loader.jar.NestedJarFile$JarEntriesEnumeration: boolean hasMoreElements()>/$stack4_$$A_2	boolean
<org.springframework.boot.loader.jar.NestedJarFile$JarEntriesEnumeration: org.springframework.boot.loader.jar.NestedJarFile$NestedJarEntry nextElement()>/@this	org.springframework.boot.loader.jar.NestedJarFile$JarEntriesEnumeration
<org.springframework.boot.loader.jar.NestedJarFile$JarEntriesEnumeration: org.springframework.boot.loader.jar.NestedJarFile$NestedJarEntry nextElement()>/this#_0	org.springframework.boot.loader.jar.NestedJarFile$JarEntriesEnumeration
<org.springframework.boot.loader.jar.NestedJarFile$JarEntriesEnumeration: org.springframework.boot.loader.jar.NestedJarFile$NestedJarEntry nextElement()>/$stack3	boolean
<org.springframework.boot.loader.jar.NestedJarFile$JarEntriesEnumeration: org.springframework.boot.loader.jar.NestedJarFile$NestedJarEntry nextElement()>/$stack4	org.springframework.boot.loader.jar.NestedJarFile
<org.springframework.boot.loader.jar.NestedJarFile$JarEntriesEnumeration: org.springframework.boot.loader.jar.NestedJarFile$NestedJarEntry nextElement()>/$stack5	org.springframework.boot.loader.jar.NestedJarFile
<org.springframework.boot.loader.jar.NestedJarFile$JarEntriesEnumeration: org.springframework.boot.loader.jar.NestedJarFile$NestedJarEntry nextElement()>/$stack6	org.springframework.boot.loader.jar.NestedJarFile$NestedJarEntry
<org.springframework.boot.loader.jar.NestedJarFile$JarEntriesEnumeration: org.springframework.boot.loader.jar.NestedJarFile$NestedJarEntry nextElement()>/$stack7	int
<org.springframework.boot.loader.jar.NestedJarFile$JarEntriesEnumeration: org.springframework.boot.loader.jar.NestedJarFile$NestedJarEntry nextElement()>/$stack8	int
<org.springframework.boot.loader.jar.NestedJarFile$JarEntriesEnumeration: org.springframework.boot.loader.jar.NestedJarFile$NestedJarEntry nextElement()>/$stack9	org.springframework.boot.loader.jar.NestedJarFile
<org.springframework.boot.loader.jar.NestedJarFile$JarEntriesEnumeration: org.springframework.boot.loader.jar.NestedJarFile$NestedJarEntry nextElement()>/$stack10	org.springframework.boot.loader.zip.ZipContent
<org.springframework.boot.loader.jar.NestedJarFile$JarEntriesEnumeration: org.springframework.boot.loader.jar.NestedJarFile$NestedJarEntry nextElement()>/$stack11	org.springframework.boot.loader.zip.ZipContent$Entry
<org.springframework.boot.loader.jar.NestedJarFile$JarEntriesEnumeration: org.springframework.boot.loader.jar.NestedJarFile$NestedJarEntry nextElement()>/$stack13	java.util.NoSuchElementException
<org.springframework.boot.loader.jar.NestedJarFile$JarEntriesEnumeration: org.springframework.boot.loader.jar.NestedJarFile$NestedJarEntry nextElement()>/$stack14	java.lang.Throwable
<org.springframework.boot.loader.jar.NestedJarFile$JarEntriesEnumeration: java.lang.Object nextElement()>/@this	org.springframework.boot.loader.jar.NestedJarFile$JarEntriesEnumeration
<org.springframework.boot.loader.jar.NestedJarFile$JarEntriesEnumeration: java.lang.Object nextElement()>/this#_0	org.springframework.boot.loader.jar.NestedJarFile$JarEntriesEnumeration
<org.springframework.boot.loader.jar.NestedJarFile$JarEntriesEnumeration: java.lang.Object nextElement()>/$stack1	org.springframework.boot.loader.jar.NestedJarFile$NestedJarEntry
<org.springframework.boot.loader.net.protocol.jar.JarUrl: void <init>()>/@this	org.springframework.boot.loader.net.protocol.jar.JarUrl
<org.springframework.boot.loader.net.protocol.jar.JarUrl: void <init>()>/this#_0	org.springframework.boot.loader.net.protocol.jar.JarUrl
<org.springframework.boot.loader.net.protocol.jar.JarUrl: java.net.URL create(java.io.File)>/@parameter0	java.io.File
<org.springframework.boot.loader.net.protocol.jar.JarUrl: java.net.URL create(java.io.File)>/file#_0	java.io.File
<org.springframework.boot.loader.net.protocol.jar.JarUrl: java.net.URL create(java.io.File)>/$stack2	java.net.URL
<org.springframework.boot.loader.net.protocol.jar.JarUrl: java.net.URL create(java.io.File)>/$null0	java.lang.String
<org.springframework.boot.loader.net.protocol.jar.JarUrl: java.net.URL create(java.io.File,java.util.jar.JarEntry)>/@parameter0	java.io.File
<org.springframework.boot.loader.net.protocol.jar.JarUrl: java.net.URL create(java.io.File,java.util.jar.JarEntry)>/@parameter1	java.util.jar.JarEntry
<org.springframework.boot.loader.net.protocol.jar.JarUrl: java.net.URL create(java.io.File,java.util.jar.JarEntry)>/file#_0	java.io.File
<org.springframework.boot.loader.net.protocol.jar.JarUrl: java.net.URL create(java.io.File,java.util.jar.JarEntry)>/nestedEntry#_0	java.util.jar.JarEntry
<org.springframework.boot.loader.net.protocol.jar.JarUrl: java.net.URL create(java.io.File,java.util.jar.JarEntry)>/$stack2	java.net.URL
<org.springframework.boot.loader.net.protocol.jar.JarUrl: java.net.URL create(java.io.File,java.util.jar.JarEntry)>/$stack4	java.lang.String
<org.springframework.boot.loader.net.protocol.jar.JarUrl: java.net.URL create(java.io.File,java.util.jar.JarEntry)>/$stack4_$$A_1	java.lang.String
<org.springframework.boot.loader.net.protocol.jar.JarUrl: java.net.URL create(java.io.File,java.util.jar.JarEntry)>/$stack4_$$A_2	java.lang.String
<org.springframework.boot.loader.net.protocol.jar.JarUrl: java.net.URL create(java.io.File,java.lang.String)>/@parameter0	java.io.File
<org.springframework.boot.loader.net.protocol.jar.JarUrl: java.net.URL create(java.io.File,java.lang.String)>/@parameter1	java.lang.String
<org.springframework.boot.loader.net.protocol.jar.JarUrl: java.net.URL create(java.io.File,java.lang.String)>/file#_0	java.io.File
<org.springframework.boot.loader.net.protocol.jar.JarUrl: java.net.URL create(java.io.File,java.lang.String)>/nestedEntryName#_0	java.lang.String
<org.springframework.boot.loader.net.protocol.jar.JarUrl: java.net.URL create(java.io.File,java.lang.String)>/$stack2	java.net.URL
<org.springframework.boot.loader.net.protocol.jar.JarUrl: java.net.URL create(java.io.File,java.lang.String)>/$null0	java.lang.String
<org.springframework.boot.loader.net.protocol.jar.JarUrl: java.net.URL create(java.io.File,java.lang.String,java.lang.String)>/@parameter0	java.io.File
<org.springframework.boot.loader.net.protocol.jar.JarUrl: java.net.URL create(java.io.File,java.lang.String,java.lang.String)>/@parameter1	java.lang.String
<org.springframework.boot.loader.net.protocol.jar.JarUrl: java.net.URL create(java.io.File,java.lang.String,java.lang.String)>/@parameter2	java.lang.String
<org.springframework.boot.loader.net.protocol.jar.JarUrl: java.net.URL create(java.io.File,java.lang.String,java.lang.String)>/$stack4	java.net.URL
<org.springframework.boot.loader.net.protocol.jar.JarUrl: java.net.URL create(java.io.File,java.lang.String,java.lang.String)>/file#_0	java.io.File
<org.springframework.boot.loader.net.protocol.jar.JarUrl: java.net.URL create(java.io.File,java.lang.String,java.lang.String)>/nestedEntryName#_0	java.lang.String
<org.springframework.boot.loader.net.protocol.jar.JarUrl: java.net.URL create(java.io.File,java.lang.String,java.lang.String)>/$stack5	java.lang.String
<org.springframework.boot.loader.net.protocol.jar.JarUrl: java.net.URL create(java.io.File,java.lang.String,java.lang.String)>/$stack6	org.springframework.boot.loader.net.protocol.jar.Handler
<org.springframework.boot.loader.net.protocol.jar.JarUrl: java.net.URL create(java.io.File,java.lang.String,java.lang.String)>/$stack7	java.lang.String
<org.springframework.boot.loader.net.protocol.jar.JarUrl: java.net.URL create(java.io.File,java.lang.String,java.lang.String)>/$stack13	java.net.MalformedURLException
<org.springframework.boot.loader.net.protocol.jar.JarUrl: java.net.URL create(java.io.File,java.lang.String,java.lang.String)>/$stack14	java.lang.IllegalStateException
<org.springframework.boot.loader.net.protocol.jar.JarUrl: java.net.URL create(java.io.File,java.lang.String,java.lang.String)>/path#_0	java.lang.String
<org.springframework.boot.loader.net.protocol.jar.JarUrl: java.net.URL create(java.io.File,java.lang.String,java.lang.String)>/$stack8	java.lang.String
<org.springframework.boot.loader.net.protocol.jar.JarUrl: java.net.URL create(java.io.File,java.lang.String,java.lang.String)>/$stack8_$$A_1	java.lang.String
<org.springframework.boot.loader.net.protocol.jar.JarUrl: java.net.URL create(java.io.File,java.lang.String,java.lang.String)>/$stack8_$$A_2	java.lang.String
<org.springframework.boot.loader.net.protocol.jar.JarUrl: java.net.URL create(java.io.File,java.lang.String,java.lang.String)>/$stringconstant0	java.lang.String
<org.springframework.boot.loader.net.protocol.jar.JarUrl: java.net.URL create(java.io.File,java.lang.String,java.lang.String)>/$null0	java.net.URL
<org.springframework.boot.loader.net.protocol.jar.JarUrl: java.net.URL create(java.io.File,java.lang.String,java.lang.String)>/$stringconstant1	java.lang.String
<org.springframework.boot.loader.net.protocol.jar.JarUrl: java.lang.String getJarReference(java.io.File,java.lang.String)>/@parameter0	java.io.File
<org.springframework.boot.loader.net.protocol.jar.JarUrl: java.lang.String getJarReference(java.io.File,java.lang.String)>/@parameter1	java.lang.String
<org.springframework.boot.loader.net.protocol.jar.JarUrl: java.lang.String getJarReference(java.io.File,java.lang.String)>/file#_0	java.io.File
<org.springframework.boot.loader.net.protocol.jar.JarUrl: java.lang.String getJarReference(java.io.File,java.lang.String)>/$stack3	java.net.URI
<org.springframework.boot.loader.net.protocol.jar.JarUrl: java.lang.String getJarReference(java.io.File,java.lang.String)>/$stack4	java.lang.String
<org.springframework.boot.loader.net.protocol.jar.JarUrl: java.lang.String getJarReference(java.io.File,java.lang.String)>/jarFilePath#_82	java.lang.String
<org.springframework.boot.loader.net.protocol.jar.JarUrl: java.lang.String getJarReference(java.io.File,java.lang.String)>/nestedEntryName#_0	java.lang.String
<org.springframework.boot.loader.net.protocol.jar.JarUrl: java.lang.String getJarReference(java.io.File,java.lang.String)>/$stack5	java.lang.String
<org.springframework.boot.loader.net.protocol.jar.JarUrl: java.lang.String getJarReference(java.io.File,java.lang.String)>/$stack5_$$A_1	java.lang.String
<org.springframework.boot.loader.net.protocol.jar.JarUrl: java.lang.String getJarReference(java.io.File,java.lang.String)>/$stack5_$$A_2	java.lang.String
<org.springframework.boot.loader.net.protocol.jar.JarUrl: java.lang.String getJarReference(java.io.File,java.lang.String)>/$stringconstant0	java.lang.String
<org.springframework.boot.loader.net.protocol.jar.JarUrl: java.lang.String getJarReference(java.io.File,java.lang.String)>/$stringconstant1	java.lang.String
<org.springframework.boot.loader.net.protocol.jar.JarUrl: java.lang.String getJarReference(java.io.File,java.lang.String)>/$stringconstant2	java.lang.String
<org.springframework.boot.loader.net.protocol.jar.JarUrl: java.lang.String getJarReference(java.io.File,java.lang.String)>/$stringconstant3	java.lang.String
<org.springframework.boot.loader.net.protocol.nested.NestedUrlConnection$ConnectionInputStream: void <init>(org.springframework.boot.loader.net.protocol.nested.NestedUrlConnection,java.io.InputStream)>/@this	org.springframework.boot.loader.net.protocol.nested.NestedUrlConnection$ConnectionInputStream
<org.springframework.boot.loader.net.protocol.nested.NestedUrlConnection$ConnectionInputStream: void <init>(org.springframework.boot.loader.net.protocol.nested.NestedUrlConnection,java.io.InputStream)>/@parameter0	org.springframework.boot.loader.net.protocol.nested.NestedUrlConnection
<org.springframework.boot.loader.net.protocol.nested.NestedUrlConnection$ConnectionInputStream: void <init>(org.springframework.boot.loader.net.protocol.nested.NestedUrlConnection,java.io.InputStream)>/@parameter1	java.io.InputStream
<org.springframework.boot.loader.net.protocol.nested.NestedUrlConnection$ConnectionInputStream: void <init>(org.springframework.boot.loader.net.protocol.nested.NestedUrlConnection,java.io.InputStream)>/this#_0	org.springframework.boot.loader.net.protocol.nested.NestedUrlConnection$ConnectionInputStream
<org.springframework.boot.loader.net.protocol.nested.NestedUrlConnection$ConnectionInputStream: void <init>(org.springframework.boot.loader.net.protocol.nested.NestedUrlConnection,java.io.InputStream)>/this$0#_0	org.springframework.boot.loader.net.protocol.nested.NestedUrlConnection
<org.springframework.boot.loader.net.protocol.nested.NestedUrlConnection$ConnectionInputStream: void <init>(org.springframework.boot.loader.net.protocol.nested.NestedUrlConnection,java.io.InputStream)>/in#_0	java.io.InputStream
<org.springframework.boot.loader.net.protocol.nested.NestedUrlConnection$ConnectionInputStream: void close()>/@this	org.springframework.boot.loader.net.protocol.nested.NestedUrlConnection$ConnectionInputStream
<org.springframework.boot.loader.net.protocol.nested.NestedUrlConnection$ConnectionInputStream: void close()>/this#_0	org.springframework.boot.loader.net.protocol.nested.NestedUrlConnection$ConnectionInputStream
<org.springframework.boot.loader.net.protocol.nested.NestedUrlConnection$ConnectionInputStream: void close()>/$stack4	boolean
<org.springframework.boot.loader.net.protocol.nested.NestedUrlConnection$ConnectionInputStream: void close()>/$stack5	org.springframework.boot.loader.net.protocol.nested.NestedUrlConnection
<org.springframework.boot.loader.net.protocol.nested.NestedUrlConnection$ConnectionInputStream: void close()>/$stack6	java.lang.ref.Cleaner$Cleanable
<org.springframework.boot.loader.net.protocol.nested.NestedUrlConnection$ConnectionInputStream: void close()>/$stack7	java.io.UncheckedIOException
<org.springframework.boot.loader.net.protocol.nested.NestedUrlConnection$ConnectionInputStream: void close()>/$stack8	java.io.IOException
<org.springframework.boot.loader.net.protocol.nested.NestedUrlConnection$ConnectionInputStream: void close()>/$stack9	java.lang.Throwable
<org.springframework.boot.loader.net.protocol.nested.NestedUrlConnection$ConnectionInputStream: void close()>/$stack10	org.springframework.boot.loader.net.protocol.nested.NestedUrlConnection
<org.springframework.boot.loader.net.protocol.nested.NestedUrlConnection$ConnectionInputStream: void close()>/$stack11	java.lang.ref.Cleaner$Cleanable
<org.springframework.boot.loader.net.protocol.nested.NestedUrlConnection$ConnectionInputStream: void close()>/$stack12	java.io.UncheckedIOException
<org.springframework.boot.loader.net.protocol.nested.NestedUrlConnection$ConnectionInputStream: void close()>/$stack13	java.io.IOException
<org.springframework.boot.loader.net.protocol.nested.NestedUrlConnection$ConnectionInputStream: void close()>/$numconstant0	boolean
<org.springframework.boot.loader.jar.NestedJarFile$RawZipDataInputStream: void <init>(org.springframework.boot.loader.jar.NestedJarFile,java.io.InputStream)>/@this	org.springframework.boot.loader.jar.NestedJarFile$RawZipDataInputStream
<org.springframework.boot.loader.jar.NestedJarFile$RawZipDataInputStream: void <init>(org.springframework.boot.loader.jar.NestedJarFile,java.io.InputStream)>/@parameter0	org.springframework.boot.loader.jar.NestedJarFile
<org.springframework.boot.loader.jar.NestedJarFile$RawZipDataInputStream: void <init>(org.springframework.boot.loader.jar.NestedJarFile,java.io.InputStream)>/@parameter1	java.io.InputStream
<org.springframework.boot.loader.jar.NestedJarFile$RawZipDataInputStream: void <init>(org.springframework.boot.loader.jar.NestedJarFile,java.io.InputStream)>/this#_0	org.springframework.boot.loader.jar.NestedJarFile$RawZipDataInputStream
<org.springframework.boot.loader.jar.NestedJarFile$RawZipDataInputStream: void <init>(org.springframework.boot.loader.jar.NestedJarFile,java.io.InputStream)>/l1#_0	org.springframework.boot.loader.jar.NestedJarFile
<org.springframework.boot.loader.jar.NestedJarFile$RawZipDataInputStream: void <init>(org.springframework.boot.loader.jar.NestedJarFile,java.io.InputStream)>/in#_0	java.io.InputStream
<org.springframework.boot.loader.jar.NestedJarFile$RawZipDataInputStream: void close()>/@this	org.springframework.boot.loader.jar.NestedJarFile$RawZipDataInputStream
<org.springframework.boot.loader.jar.NestedJarFile$RawZipDataInputStream: void close()>/this#_0	org.springframework.boot.loader.jar.NestedJarFile$RawZipDataInputStream
<org.springframework.boot.loader.jar.NestedJarFile$RawZipDataInputStream: void close()>/$stack1	boolean
<org.springframework.boot.loader.jar.NestedJarFile$RawZipDataInputStream: void close()>/$stack2	org.springframework.boot.loader.jar.NestedJarFile
<org.springframework.boot.loader.jar.NestedJarFile$RawZipDataInputStream: void close()>/$stack3	org.springframework.boot.loader.jar.NestedJarFileResources
<org.springframework.boot.loader.jar.NestedJarFile$RawZipDataInputStream: void close()>/$numconstant0	boolean
<org.springframework.boot.loader.net.protocol.jar.UrlJarManifest: void <init>(org.springframework.boot.loader.net.protocol.jar.UrlJarManifest$ManifestSupplier)>/@this	org.springframework.boot.loader.net.protocol.jar.UrlJarManifest
<org.springframework.boot.loader.net.protocol.jar.UrlJarManifest: void <init>(org.springframework.boot.loader.net.protocol.jar.UrlJarManifest$ManifestSupplier)>/@parameter0	org.springframework.boot.loader.net.protocol.jar.UrlJarManifest$ManifestSupplier
<org.springframework.boot.loader.net.protocol.jar.UrlJarManifest: void <init>(org.springframework.boot.loader.net.protocol.jar.UrlJarManifest$ManifestSupplier)>/this#_0	org.springframework.boot.loader.net.protocol.jar.UrlJarManifest
<org.springframework.boot.loader.net.protocol.jar.UrlJarManifest: void <init>(org.springframework.boot.loader.net.protocol.jar.UrlJarManifest$ManifestSupplier)>/supplier#_0	org.springframework.boot.loader.net.protocol.jar.UrlJarManifest$ManifestSupplier
<org.springframework.boot.loader.net.protocol.jar.UrlJarManifest: java.util.jar.Manifest get()>/@this	org.springframework.boot.loader.net.protocol.jar.UrlJarManifest
<org.springframework.boot.loader.net.protocol.jar.UrlJarManifest: java.util.jar.Manifest get()>/this#_0	org.springframework.boot.loader.net.protocol.jar.UrlJarManifest
<org.springframework.boot.loader.net.protocol.jar.UrlJarManifest: java.util.jar.Manifest get()>/manifest#_44	java.util.jar.Manifest
<org.springframework.boot.loader.net.protocol.jar.UrlJarManifest: java.util.jar.Manifest get()>/$stack3	java.util.jar.Manifest
<org.springframework.boot.loader.net.protocol.jar.UrlJarManifest: java.util.jar.Manifest get()>/$stack4	java.util.jar.Attributes
<org.springframework.boot.loader.net.protocol.jar.UrlJarManifest: java.util.jar.Manifest get()>/$stack5	java.lang.Object
<org.springframework.boot.loader.net.protocol.jar.UrlJarManifest: java.util.jar.Manifest get()>/$stack6	java.util.Map
<org.springframework.boot.loader.net.protocol.jar.UrlJarManifest: java.util.jar.Manifest get()>/$stack7	java.util.jar.Attributes
<org.springframework.boot.loader.net.protocol.jar.UrlJarManifest: java.util.jar.Manifest get()>/$stack8	java.util.function.BiConsumer
<org.springframework.boot.loader.net.protocol.jar.UrlJarManifest: java.util.jar.Manifest get()>/$stack9	java.util.Map
<org.springframework.boot.loader.net.protocol.jar.UrlJarManifest: java.util.jar.Manifest get()>/$null0	java.util.jar.Manifest
<org.springframework.boot.loader.net.protocol.jar.UrlJarManifest: java.util.jar.Manifest get()>/$methodtypeconstant0	java.lang.invoke.MethodType
<org.springframework.boot.loader.net.protocol.jar.UrlJarManifest: java.util.jar.Manifest get()>/$mhandleconstant0	java.lang.invoke.MethodHandle
<org.springframework.boot.loader.net.protocol.jar.UrlJarManifest: java.util.jar.Manifest get()>/$methodtypeconstant1	java.lang.invoke.MethodType
<org.springframework.boot.loader.net.protocol.jar.UrlJarManifest: java.util.jar.Attributes getEntryAttributes(java.util.jar.JarEntry)>/@this	org.springframework.boot.loader.net.protocol.jar.UrlJarManifest
<org.springframework.boot.loader.net.protocol.jar.UrlJarManifest: java.util.jar.Attributes getEntryAttributes(java.util.jar.JarEntry)>/@parameter0	java.util.jar.JarEntry
<org.springframework.boot.loader.net.protocol.jar.UrlJarManifest: java.util.jar.Attributes getEntryAttributes(java.util.jar.JarEntry)>/this#_0	org.springframework.boot.loader.net.protocol.jar.UrlJarManifest
<org.springframework.boot.loader.net.protocol.jar.UrlJarManifest: java.util.jar.Attributes getEntryAttributes(java.util.jar.JarEntry)>/manifest#_55	java.util.jar.Manifest
<org.springframework.boot.loader.net.protocol.jar.UrlJarManifest: java.util.jar.Attributes getEntryAttributes(java.util.jar.JarEntry)>/entry#_0	java.util.jar.JarEntry
<org.springframework.boot.loader.net.protocol.jar.UrlJarManifest: java.util.jar.Attributes getEntryAttributes(java.util.jar.JarEntry)>/$stack4	java.lang.String
<org.springframework.boot.loader.net.protocol.jar.UrlJarManifest: java.util.jar.Attributes getEntryAttributes(java.util.jar.JarEntry)>/$stack5	java.util.Map
<org.springframework.boot.loader.net.protocol.jar.UrlJarManifest: java.util.jar.Attributes getEntryAttributes(java.util.jar.JarEntry)>/$stack6	java.lang.Object
<org.springframework.boot.loader.net.protocol.jar.UrlJarManifest: java.util.jar.Attributes getEntryAttributes(java.util.jar.JarEntry)>/attributes#_59	java.util.jar.Attributes
<org.springframework.boot.loader.net.protocol.jar.UrlJarManifest: java.util.jar.Attributes getEntryAttributes(java.util.jar.JarEntry)>/$stack7	java.util.jar.Attributes
<org.springframework.boot.loader.net.protocol.jar.UrlJarManifest: java.util.jar.Attributes getEntryAttributes(java.util.jar.JarEntry)>/$null0	java.util.jar.Attributes
<org.springframework.boot.loader.net.protocol.jar.UrlJarManifest: java.util.jar.Attributes cloneAttributes(java.util.jar.Attributes)>/@this	org.springframework.boot.loader.net.protocol.jar.UrlJarManifest
<org.springframework.boot.loader.net.protocol.jar.UrlJarManifest: java.util.jar.Attributes cloneAttributes(java.util.jar.Attributes)>/@parameter0	java.util.jar.Attributes
<org.springframework.boot.loader.net.protocol.jar.UrlJarManifest: java.util.jar.Attributes cloneAttributes(java.util.jar.Attributes)>/attributes#_0	java.util.jar.Attributes
<org.springframework.boot.loader.net.protocol.jar.UrlJarManifest: java.util.jar.Attributes cloneAttributes(java.util.jar.Attributes)>/$stack2	java.lang.Object
<org.springframework.boot.loader.net.protocol.jar.UrlJarManifest: java.util.jar.Attributes cloneAttributes(java.util.jar.Attributes)>/this#_0	org.springframework.boot.loader.net.protocol.jar.UrlJarManifest
<org.springframework.boot.loader.net.protocol.jar.UrlJarManifest: java.util.jar.Attributes cloneAttributes(java.util.jar.Attributes)>/$stack3	java.util.jar.Attributes
<org.springframework.boot.loader.net.protocol.jar.UrlJarManifest: java.util.jar.Attributes cloneAttributes(java.util.jar.Attributes)>/$stack3_$$A_1	java.util.jar.Attributes
<org.springframework.boot.loader.net.protocol.jar.UrlJarManifest: java.util.jar.Attributes cloneAttributes(java.util.jar.Attributes)>/$stack3_$$A_2	java.util.jar.Attributes
<org.springframework.boot.loader.net.protocol.jar.UrlJarManifest: java.util.jar.Manifest supply()>/@this	org.springframework.boot.loader.net.protocol.jar.UrlJarManifest
<org.springframework.boot.loader.net.protocol.jar.UrlJarManifest: java.util.jar.Manifest supply()>/this#_0	org.springframework.boot.loader.net.protocol.jar.UrlJarManifest
<org.springframework.boot.loader.net.protocol.jar.UrlJarManifest: java.util.jar.Manifest supply()>/$stack4	org.springframework.boot.loader.net.protocol.jar.UrlJarManifest$ManifestSupplier
<org.springframework.boot.loader.net.protocol.jar.UrlJarManifest: java.util.jar.Manifest supply()>/supplied#_68	java.lang.Object
<org.springframework.boot.loader.net.protocol.jar.UrlJarManifest: java.util.jar.Manifest supply()>/$stack5	java.lang.Object
<org.springframework.boot.loader.net.protocol.jar.UrlJarManifest: java.util.jar.Manifest supply()>/$stack2	java.lang.Object
<org.springframework.boot.loader.net.protocol.jar.UrlJarManifest: java.util.jar.Manifest supply()>/$stack3	java.util.jar.Manifest
<org.springframework.boot.loader.net.protocol.jar.UrlJarManifest: java.util.jar.Manifest supply()>/supplied_$$A_1#_70	java.lang.Object
<org.springframework.boot.loader.net.protocol.jar.UrlJarManifest: java.util.jar.Manifest supply()>/$stack5_$$A_1	java.lang.Object
<org.springframework.boot.loader.net.protocol.jar.UrlJarManifest: java.util.jar.Manifest supply()>/$stack5_$$A_2	java.lang.Object
<org.springframework.boot.loader.net.protocol.jar.UrlJarManifest: java.util.jar.Manifest supply()>/$stack5_$$A_3	java.lang.Object
<org.springframework.boot.loader.net.protocol.jar.UrlJarManifest: java.util.jar.Manifest supply()>/supplied_$$A_2#_72	java.lang.Object
<org.springframework.boot.loader.net.protocol.jar.UrlJarManifest: java.util.jar.Manifest supply()>/$stack3_$$A_1	java.util.jar.Manifest
<org.springframework.boot.loader.net.protocol.jar.UrlJarManifest: java.util.jar.Manifest supply()>/$stack3_$$A_2	java.util.jar.Manifest
<org.springframework.boot.loader.net.protocol.jar.UrlJarManifest: void lambda$get$0(java.util.jar.Manifest,java.lang.String,java.util.jar.Attributes)>/@this	org.springframework.boot.loader.net.protocol.jar.UrlJarManifest
<org.springframework.boot.loader.net.protocol.jar.UrlJarManifest: void lambda$get$0(java.util.jar.Manifest,java.lang.String,java.util.jar.Attributes)>/@parameter0	java.util.jar.Manifest
<org.springframework.boot.loader.net.protocol.jar.UrlJarManifest: void lambda$get$0(java.util.jar.Manifest,java.lang.String,java.util.jar.Attributes)>/@parameter1	java.lang.String
<org.springframework.boot.loader.net.protocol.jar.UrlJarManifest: void lambda$get$0(java.util.jar.Manifest,java.lang.String,java.util.jar.Attributes)>/@parameter2	java.util.jar.Attributes
<org.springframework.boot.loader.net.protocol.jar.UrlJarManifest: void lambda$get$0(java.util.jar.Manifest,java.lang.String,java.util.jar.Attributes)>/copy#_0	java.util.jar.Manifest
<org.springframework.boot.loader.net.protocol.jar.UrlJarManifest: void lambda$get$0(java.util.jar.Manifest,java.lang.String,java.util.jar.Attributes)>/key#_0	java.lang.String
<org.springframework.boot.loader.net.protocol.jar.UrlJarManifest: void lambda$get$0(java.util.jar.Manifest,java.lang.String,java.util.jar.Attributes)>/this#_0	org.springframework.boot.loader.net.protocol.jar.UrlJarManifest
<org.springframework.boot.loader.net.protocol.jar.UrlJarManifest: void lambda$get$0(java.util.jar.Manifest,java.lang.String,java.util.jar.Attributes)>/value#_0	java.util.jar.Attributes
<org.springframework.boot.loader.net.protocol.jar.UrlJarManifest: void lambda$get$0(java.util.jar.Manifest,java.lang.String,java.util.jar.Attributes)>/$stack4	java.util.jar.Attributes
<org.springframework.boot.loader.net.protocol.jar.UrlJarManifest: void lambda$get$0(java.util.jar.Manifest,java.lang.String,java.util.jar.Attributes)>/$stack5	java.util.Map
<org.springframework.boot.loader.net.protocol.jar.UrlJarManifest: void <clinit>()>/$stack0	java.lang.Object
<org.springframework.boot.loader.launch.ExplodedArchive$FileArchiveEntry: void <init>(java.lang.String,java.io.File)>/@this	org.springframework.boot.loader.launch.ExplodedArchive$FileArchiveEntry
<org.springframework.boot.loader.launch.ExplodedArchive$FileArchiveEntry: void <init>(java.lang.String,java.io.File)>/@parameter0	java.lang.String
<org.springframework.boot.loader.launch.ExplodedArchive$FileArchiveEntry: void <init>(java.lang.String,java.io.File)>/@parameter1	java.io.File
<org.springframework.boot.loader.launch.ExplodedArchive$FileArchiveEntry: void <init>(java.lang.String,java.io.File)>/this#_0	org.springframework.boot.loader.launch.ExplodedArchive$FileArchiveEntry
<org.springframework.boot.loader.launch.ExplodedArchive$FileArchiveEntry: void <init>(java.lang.String,java.io.File)>/name#_0	java.lang.String
<org.springframework.boot.loader.launch.ExplodedArchive$FileArchiveEntry: void <init>(java.lang.String,java.io.File)>/file#_0	java.io.File
<org.springframework.boot.loader.launch.ExplodedArchive$FileArchiveEntry: boolean isDirectory()>/@this	org.springframework.boot.loader.launch.ExplodedArchive$FileArchiveEntry
<org.springframework.boot.loader.launch.ExplodedArchive$FileArchiveEntry: boolean isDirectory()>/this#_0	org.springframework.boot.loader.launch.ExplodedArchive$FileArchiveEntry
<org.springframework.boot.loader.launch.ExplodedArchive$FileArchiveEntry: boolean isDirectory()>/$stack1	java.io.File
<org.springframework.boot.loader.launch.ExplodedArchive$FileArchiveEntry: boolean isDirectory()>/$stack2	boolean
<org.springframework.boot.loader.launch.ExplodedArchive$FileArchiveEntry: java.lang.String toString()>/@this	org.springframework.boot.loader.launch.ExplodedArchive$FileArchiveEntry
<org.springframework.boot.loader.launch.ExplodedArchive$FileArchiveEntry: java.lang.String toString()>/this#_0	org.springframework.boot.loader.launch.ExplodedArchive$FileArchiveEntry
<org.springframework.boot.loader.launch.ExplodedArchive$FileArchiveEntry: java.lang.String toString()>/$stack1	java.lang.String
<org.springframework.boot.loader.launch.ExplodedArchive$FileArchiveEntry: java.lang.String toString()>/$classconstant0	java.lang.Class
<org.springframework.boot.loader.launch.ExplodedArchive$FileArchiveEntry: java.lang.String toString()>/$stringconstant0	java.lang.String
<org.springframework.boot.loader.launch.ExplodedArchive$FileArchiveEntry: java.lang.String toString()>/$mhandleconstant0	java.lang.invoke.MethodHandle
