<com.matt_richardson.gocd.websocket_notifier.PipelineWebSocketServer: void <init>(int)>/assign/2	<com.matt_richardson.gocd.websocket_notifier.PipelineWebSocketServer: void <init>(int)>/$stack2
<com.matt_richardson.gocd.websocket_notifier.PipelineWebSocketServer: void <init>(int)>/fresh-null-assign/0	<com.matt_richardson.gocd.websocket_notifier.PipelineWebSocketServer: void <init>(int)>/$classconstant0
<com.matt_richardson.gocd.websocket_notifier.PipelineWebSocketServer: void <init>(java.lang.String,int)>/assign/3	<com.matt_richardson.gocd.websocket_notifier.PipelineWebSocketServer: void <init>(java.lang.String,int)>/$stack3
<com.matt_richardson.gocd.websocket_notifier.PipelineWebSocketServer: void <init>(java.lang.String,int)>/fresh-null-assign/0	<com.matt_richardson.gocd.websocket_notifier.PipelineWebSocketServer: void <init>(java.lang.String,int)>/$classconstant0
<com.matt_richardson.gocd.websocket_notifier.PipelineWebSocketServer: void onOpen(org.java_websocket.WebSocket,org.java_websocket.handshake.ClientHandshake)>/assign/3	<com.matt_richardson.gocd.websocket_notifier.PipelineWebSocketServer: void onOpen(org.java_websocket.WebSocket,org.java_websocket.handshake.ClientHandshake)>/$stack3
<com.matt_richardson.gocd.websocket_notifier.PipelineWebSocketServer: void onOpen(org.java_websocket.WebSocket,org.java_websocket.handshake.ClientHandshake)>/fresh-null-assign/0	<com.matt_richardson.gocd.websocket_notifier.PipelineWebSocketServer: void onOpen(org.java_websocket.WebSocket,org.java_websocket.handshake.ClientHandshake)>/$stringconstant0
<com.matt_richardson.gocd.websocket_notifier.PipelineWebSocketServer: void onClose(org.java_websocket.WebSocket,int,java.lang.String,boolean)>/assign/5	<com.matt_richardson.gocd.websocket_notifier.PipelineWebSocketServer: void onClose(org.java_websocket.WebSocket,int,java.lang.String,boolean)>/$stack5
<com.matt_richardson.gocd.websocket_notifier.PipelineWebSocketServer: void onClose(org.java_websocket.WebSocket,int,java.lang.String,boolean)>/fresh-null-assign/0	<com.matt_richardson.gocd.websocket_notifier.PipelineWebSocketServer: void onClose(org.java_websocket.WebSocket,int,java.lang.String,boolean)>/$stringconstant0
<com.matt_richardson.gocd.websocket_notifier.PipelineWebSocketServer: void onError(org.java_websocket.WebSocket,java.lang.Exception)>/fresh-null-assign/0	<com.matt_richardson.gocd.websocket_notifier.PipelineWebSocketServer: void onError(org.java_websocket.WebSocket,java.lang.Exception)>/$stringconstant0
<com.matt_richardson.gocd.websocket_notifier.PipelineWebSocketServer: void sendToAll(java.lang.String)>/assign/6	<com.matt_richardson.gocd.websocket_notifier.PipelineWebSocketServer: void sendToAll(java.lang.String)>/$stack11
<com.matt_richardson.gocd.websocket_notifier.PipelineWebSocketServer: void sendToAll(java.lang.String)>/fresh-null-assign/0	<com.matt_richardson.gocd.websocket_notifier.PipelineWebSocketServer: void sendToAll(java.lang.String)>/$stringconstant0
<com.matt_richardson.gocd.websocket_notifier.PipelineWebSocketServer: void sendToAll(java.lang.String)>/fresh-null-assign/1	<com.matt_richardson.gocd.websocket_notifier.PipelineWebSocketServer: void sendToAll(java.lang.String)>/$stringconstant1
<com.matt_richardson.gocd.websocket_notifier.GoNotificationPlugin: void initializeGoApplicationAccessor(com.thoughtworks.go.plugin.api.GoApplicationAccessor)>/assign/2	<com.matt_richardson.gocd.websocket_notifier.GoNotificationPlugin: void initializeGoApplicationAccessor(com.thoughtworks.go.plugin.api.GoApplicationAccessor)>/$stack8
<com.matt_richardson.gocd.websocket_notifier.GoNotificationPlugin: void initializeGoApplicationAccessor(com.thoughtworks.go.plugin.api.GoApplicationAccessor)>/assign/5	<com.matt_richardson.gocd.websocket_notifier.GoNotificationPlugin: void initializeGoApplicationAccessor(com.thoughtworks.go.plugin.api.GoApplicationAccessor)>/$stack9
<com.matt_richardson.gocd.websocket_notifier.GoNotificationPlugin: void initializeGoApplicationAccessor(com.thoughtworks.go.plugin.api.GoApplicationAccessor)>/fresh-null-assign/0	<com.matt_richardson.gocd.websocket_notifier.GoNotificationPlugin: void initializeGoApplicationAccessor(com.thoughtworks.go.plugin.api.GoApplicationAccessor)>/$stringconstant0
<com.matt_richardson.gocd.websocket_notifier.GoNotificationPlugin: void initializeGoApplicationAccessor(com.thoughtworks.go.plugin.api.GoApplicationAccessor)>/assign/10	<com.matt_richardson.gocd.websocket_notifier.GoNotificationPlugin: void initializeGoApplicationAccessor(com.thoughtworks.go.plugin.api.GoApplicationAccessor)>/$stack23
<com.matt_richardson.gocd.websocket_notifier.GoNotificationPlugin: void initializeGoApplicationAccessor(com.thoughtworks.go.plugin.api.GoApplicationAccessor)>/assign/12	<com.matt_richardson.gocd.websocket_notifier.GoNotificationPlugin: void initializeGoApplicationAccessor(com.thoughtworks.go.plugin.api.GoApplicationAccessor)>/$stack15
<com.matt_richardson.gocd.websocket_notifier.GoNotificationPlugin: void initializeGoApplicationAccessor(com.thoughtworks.go.plugin.api.GoApplicationAccessor)>/assign/15	<com.matt_richardson.gocd.websocket_notifier.GoNotificationPlugin: void initializeGoApplicationAccessor(com.thoughtworks.go.plugin.api.GoApplicationAccessor)>/$stack16
<com.matt_richardson.gocd.websocket_notifier.GoNotificationPlugin: void initializeGoApplicationAccessor(com.thoughtworks.go.plugin.api.GoApplicationAccessor)>/fresh-null-assign/1	<com.matt_richardson.gocd.websocket_notifier.GoNotificationPlugin: void initializeGoApplicationAccessor(com.thoughtworks.go.plugin.api.GoApplicationAccessor)>/$stringconstant1
<com.matt_richardson.gocd.websocket_notifier.GoNotificationPlugin: void initializeGoApplicationAccessor(com.thoughtworks.go.plugin.api.GoApplicationAccessor)>/assign/20	<com.matt_richardson.gocd.websocket_notifier.GoNotificationPlugin: void initializeGoApplicationAccessor(com.thoughtworks.go.plugin.api.GoApplicationAccessor)>/$stack22
<com.matt_richardson.gocd.websocket_notifier.GoNotificationPlugin: void initializeGoApplicationAccessor(com.thoughtworks.go.plugin.api.GoApplicationAccessor)>/assign/23	<com.matt_richardson.gocd.websocket_notifier.GoNotificationPlugin: void initializeGoApplicationAccessor(com.thoughtworks.go.plugin.api.GoApplicationAccessor)>/$stack30
<com.matt_richardson.gocd.websocket_notifier.GoNotificationPlugin: void initializeGoApplicationAccessor(com.thoughtworks.go.plugin.api.GoApplicationAccessor)>/fresh-null-assign/2	<com.matt_richardson.gocd.websocket_notifier.GoNotificationPlugin: void initializeGoApplicationAccessor(com.thoughtworks.go.plugin.api.GoApplicationAccessor)>/$stringconstant2
<com.matt_richardson.gocd.websocket_notifier.GoNotificationPlugin: com.thoughtworks.go.plugin.api.response.GoPluginApiResponse handle(com.thoughtworks.go.plugin.api.request.GoPluginApiRequest)>/assign/2	<com.matt_richardson.gocd.websocket_notifier.GoNotificationPlugin: com.thoughtworks.go.plugin.api.response.GoPluginApiResponse handle(com.thoughtworks.go.plugin.api.request.GoPluginApiRequest)>/$u0
<com.matt_richardson.gocd.websocket_notifier.GoNotificationPlugin: com.thoughtworks.go.plugin.api.response.GoPluginApiResponse handle(com.thoughtworks.go.plugin.api.request.GoPluginApiRequest)>/fresh-null-assign/0	<com.matt_richardson.gocd.websocket_notifier.GoNotificationPlugin: com.thoughtworks.go.plugin.api.response.GoPluginApiResponse handle(com.thoughtworks.go.plugin.api.request.GoPluginApiRequest)>/$stringconstant0
<com.matt_richardson.gocd.websocket_notifier.GoNotificationPlugin: com.thoughtworks.go.plugin.api.response.GoPluginApiResponse handle(com.thoughtworks.go.plugin.api.request.GoPluginApiRequest)>/fresh-null-assign/1	<com.matt_richardson.gocd.websocket_notifier.GoNotificationPlugin: com.thoughtworks.go.plugin.api.response.GoPluginApiResponse handle(com.thoughtworks.go.plugin.api.request.GoPluginApiRequest)>/$stringconstant1
<com.matt_richardson.gocd.websocket_notifier.GoNotificationPlugin: com.thoughtworks.go.plugin.api.response.GoPluginApiResponse handle(com.thoughtworks.go.plugin.api.request.GoPluginApiRequest)>/fresh-null-assign/2	<com.matt_richardson.gocd.websocket_notifier.GoNotificationPlugin: com.thoughtworks.go.plugin.api.response.GoPluginApiResponse handle(com.thoughtworks.go.plugin.api.request.GoPluginApiRequest)>/$stringconstant2
<com.matt_richardson.gocd.websocket_notifier.GoNotificationPlugin: com.thoughtworks.go.plugin.api.response.GoPluginApiResponse handle(com.thoughtworks.go.plugin.api.request.GoPluginApiRequest)>/assign/13	<com.matt_richardson.gocd.websocket_notifier.GoNotificationPlugin: com.thoughtworks.go.plugin.api.response.GoPluginApiResponse handle(com.thoughtworks.go.plugin.api.request.GoPluginApiRequest)>/$u1
<com.matt_richardson.gocd.websocket_notifier.GoNotificationPlugin: com.thoughtworks.go.plugin.api.response.GoPluginApiResponse handle(com.thoughtworks.go.plugin.api.request.GoPluginApiRequest)>/fresh-null-assign/3	<com.matt_richardson.gocd.websocket_notifier.GoNotificationPlugin: com.thoughtworks.go.plugin.api.response.GoPluginApiResponse handle(com.thoughtworks.go.plugin.api.request.GoPluginApiRequest)>/$stringconstant3
<com.matt_richardson.gocd.websocket_notifier.GoNotificationPlugin: com.thoughtworks.go.plugin.api.response.GoPluginApiResponse handle(com.thoughtworks.go.plugin.api.request.GoPluginApiRequest)>/assign/20	<com.matt_richardson.gocd.websocket_notifier.GoNotificationPlugin: com.thoughtworks.go.plugin.api.response.GoPluginApiResponse handle(com.thoughtworks.go.plugin.api.request.GoPluginApiRequest)>/$stack22
<com.matt_richardson.gocd.websocket_notifier.GoNotificationPlugin: com.thoughtworks.go.plugin.api.response.GoPluginApiResponse handle(com.thoughtworks.go.plugin.api.request.GoPluginApiRequest)>/fresh-null-assign/4	<com.matt_richardson.gocd.websocket_notifier.GoNotificationPlugin: com.thoughtworks.go.plugin.api.response.GoPluginApiResponse handle(com.thoughtworks.go.plugin.api.request.GoPluginApiRequest)>/$stringconstant4
<com.matt_richardson.gocd.websocket_notifier.GoNotificationPlugin: com.thoughtworks.go.plugin.api.GoPluginIdentifier pluginIdentifier()>/fresh-null-assign/0	<com.matt_richardson.gocd.websocket_notifier.GoNotificationPlugin: com.thoughtworks.go.plugin.api.GoPluginIdentifier pluginIdentifier()>/$stringconstant0
<com.matt_richardson.gocd.websocket_notifier.GoNotificationPlugin: com.thoughtworks.go.plugin.api.GoPluginIdentifier pluginIdentifier()>/assign/1	<com.matt_richardson.gocd.websocket_notifier.GoNotificationPlugin: com.thoughtworks.go.plugin.api.GoPluginIdentifier pluginIdentifier()>/$stack2
<com.matt_richardson.gocd.websocket_notifier.GoNotificationPlugin: com.thoughtworks.go.plugin.api.GoPluginIdentifier pluginIdentifier()>/fresh-null-assign/1	<com.matt_richardson.gocd.websocket_notifier.GoNotificationPlugin: com.thoughtworks.go.plugin.api.GoPluginIdentifier pluginIdentifier()>/$stringconstant1
<com.matt_richardson.gocd.websocket_notifier.GoNotificationPlugin: com.thoughtworks.go.plugin.api.response.GoPluginApiResponse handleNotificationsInterestedIn()>/assign/1	<com.matt_richardson.gocd.websocket_notifier.GoNotificationPlugin: com.thoughtworks.go.plugin.api.response.GoPluginApiResponse handleNotificationsInterestedIn()>/$stack2
<com.matt_richardson.gocd.websocket_notifier.GoNotificationPlugin: com.thoughtworks.go.plugin.api.response.GoPluginApiResponse handleNotificationsInterestedIn()>/assign/2	<com.matt_richardson.gocd.websocket_notifier.GoNotificationPlugin: com.thoughtworks.go.plugin.api.response.GoPluginApiResponse handleNotificationsInterestedIn()>/$stack3
<com.matt_richardson.gocd.websocket_notifier.GoNotificationPlugin: com.thoughtworks.go.plugin.api.response.GoPluginApiResponse handleNotificationsInterestedIn()>/fresh-null-assign/0	<com.matt_richardson.gocd.websocket_notifier.GoNotificationPlugin: com.thoughtworks.go.plugin.api.response.GoPluginApiResponse handleNotificationsInterestedIn()>/$stringconstant0
<com.matt_richardson.gocd.websocket_notifier.GoNotificationPlugin: com.thoughtworks.go.plugin.api.response.GoPluginApiResponse handleNotificationsInterestedIn()>/fresh-null-assign/1	<com.matt_richardson.gocd.websocket_notifier.GoNotificationPlugin: com.thoughtworks.go.plugin.api.response.GoPluginApiResponse handleNotificationsInterestedIn()>/$stringconstant1
<com.matt_richardson.gocd.websocket_notifier.GoNotificationPlugin: com.thoughtworks.go.plugin.api.response.GoPluginApiResponse handleNotificationsInterestedIn()>/fresh-null-assign/2	<com.matt_richardson.gocd.websocket_notifier.GoNotificationPlugin: com.thoughtworks.go.plugin.api.response.GoPluginApiResponse handleNotificationsInterestedIn()>/$stringconstant2
<com.matt_richardson.gocd.websocket_notifier.GoNotificationPlugin: com.thoughtworks.go.plugin.api.response.GoPluginApiResponse handleStageNotification(com.thoughtworks.go.plugin.api.request.GoPluginApiRequest)>/fresh-null-assign/0	<com.matt_richardson.gocd.websocket_notifier.GoNotificationPlugin: com.thoughtworks.go.plugin.api.response.GoPluginApiResponse handleStageNotification(com.thoughtworks.go.plugin.api.request.GoPluginApiRequest)>/$stringconstant0
<com.matt_richardson.gocd.websocket_notifier.GoNotificationPlugin: com.thoughtworks.go.plugin.api.response.GoPluginApiResponse handleStageNotification(com.thoughtworks.go.plugin.api.request.GoPluginApiRequest)>/assign/3	<com.matt_richardson.gocd.websocket_notifier.GoNotificationPlugin: com.thoughtworks.go.plugin.api.response.GoPluginApiResponse handleStageNotification(com.thoughtworks.go.plugin.api.request.GoPluginApiRequest)>/$stack7
<com.matt_richardson.gocd.websocket_notifier.GoNotificationPlugin: com.thoughtworks.go.plugin.api.response.GoPluginApiResponse handleStageNotification(com.thoughtworks.go.plugin.api.request.GoPluginApiRequest)>/assign/4	<com.matt_richardson.gocd.websocket_notifier.GoNotificationPlugin: com.thoughtworks.go.plugin.api.response.GoPluginApiResponse handleStageNotification(com.thoughtworks.go.plugin.api.request.GoPluginApiRequest)>/$stack8
<com.matt_richardson.gocd.websocket_notifier.GoNotificationPlugin: com.thoughtworks.go.plugin.api.response.GoPluginApiResponse handleStageNotification(com.thoughtworks.go.plugin.api.request.GoPluginApiRequest)>/fresh-null-assign/1	<com.matt_richardson.gocd.websocket_notifier.GoNotificationPlugin: com.thoughtworks.go.plugin.api.response.GoPluginApiResponse handleStageNotification(com.thoughtworks.go.plugin.api.request.GoPluginApiRequest)>/$stringconstant1
<com.matt_richardson.gocd.websocket_notifier.GoNotificationPlugin: com.thoughtworks.go.plugin.api.response.GoPluginApiResponse handleStageNotification(com.thoughtworks.go.plugin.api.request.GoPluginApiRequest)>/fresh-null-assign/2	<com.matt_richardson.gocd.websocket_notifier.GoNotificationPlugin: com.thoughtworks.go.plugin.api.response.GoPluginApiResponse handleStageNotification(com.thoughtworks.go.plugin.api.request.GoPluginApiRequest)>/$stringconstant2
<com.matt_richardson.gocd.websocket_notifier.GoNotificationPlugin: com.thoughtworks.go.plugin.api.response.GoPluginApiResponse handleStageNotification(com.thoughtworks.go.plugin.api.request.GoPluginApiRequest)>/fresh-null-assign/3	<com.matt_richardson.gocd.websocket_notifier.GoNotificationPlugin: com.thoughtworks.go.plugin.api.response.GoPluginApiResponse handleStageNotification(com.thoughtworks.go.plugin.api.request.GoPluginApiRequest)>/$stringconstant3
<com.matt_richardson.gocd.websocket_notifier.GoNotificationPlugin: com.thoughtworks.go.plugin.api.response.GoPluginApiResponse handleStageNotification(com.thoughtworks.go.plugin.api.request.GoPluginApiRequest)>/fresh-null-assign/4	<com.matt_richardson.gocd.websocket_notifier.GoNotificationPlugin: com.thoughtworks.go.plugin.api.response.GoPluginApiResponse handleStageNotification(com.thoughtworks.go.plugin.api.request.GoPluginApiRequest)>/$stringconstant4
<com.matt_richardson.gocd.websocket_notifier.GoNotificationPlugin: com.thoughtworks.go.plugin.api.response.GoPluginApiResponse handleStageNotification(com.thoughtworks.go.plugin.api.request.GoPluginApiRequest)>/fresh-null-assign/5	<com.matt_richardson.gocd.websocket_notifier.GoNotificationPlugin: com.thoughtworks.go.plugin.api.response.GoPluginApiResponse handleStageNotification(com.thoughtworks.go.plugin.api.request.GoPluginApiRequest)>/$stringconstant5
<com.matt_richardson.gocd.websocket_notifier.GoNotificationPlugin: com.thoughtworks.go.plugin.api.response.GoPluginApiResponse handleStageNotification(com.thoughtworks.go.plugin.api.request.GoPluginApiRequest)>/fresh-null-assign/6	<com.matt_richardson.gocd.websocket_notifier.GoNotificationPlugin: com.thoughtworks.go.plugin.api.response.GoPluginApiResponse handleStageNotification(com.thoughtworks.go.plugin.api.request.GoPluginApiRequest)>/$stringconstant6
<com.matt_richardson.gocd.websocket_notifier.GoNotificationPlugin: com.thoughtworks.go.plugin.api.response.GoPluginApiResponse renderJSON(int,java.lang.Object)>/assign/4	<com.matt_richardson.gocd.websocket_notifier.GoNotificationPlugin: com.thoughtworks.go.plugin.api.response.GoPluginApiResponse renderJSON(int,java.lang.Object)>/$stack4
<com.matt_richardson.gocd.websocket_notifier.GoNotificationPlugin: com.thoughtworks.go.plugin.api.response.GoPluginApiResponse renderJSON(int,java.lang.Object)>/assign/8	<com.matt_richardson.gocd.websocket_notifier.GoNotificationPlugin: com.thoughtworks.go.plugin.api.response.GoPluginApiResponse renderJSON(int,java.lang.Object)>/$stack6
<com.matt_richardson.gocd.websocket_notifier.GoNotificationPlugin: void <clinit>()>/fresh-null-assign/0	<com.matt_richardson.gocd.websocket_notifier.GoNotificationPlugin: void <clinit>()>/$classconstant0
<com.matt_richardson.gocd.websocket_notifier.GoNotificationPlugin: void <clinit>()>/assign/1	<com.matt_richardson.gocd.websocket_notifier.GoNotificationPlugin: void <clinit>()>/$stack1
<com.matt_richardson.gocd.websocket_notifier.GoNotificationPlugin: void <clinit>()>/fresh-null-assign/1	<com.matt_richardson.gocd.websocket_notifier.GoNotificationPlugin: void <clinit>()>/$stringconstant0
<com.matt_richardson.gocd.websocket_notifier.PluginConfig: void <init>()>/fresh-null-assign/1	<com.matt_richardson.gocd.websocket_notifier.PluginConfig: void <init>()>/$stringconstant0
<com.matt_richardson.gocd.websocket_notifier.PluginConfig: void <init>()>/fresh-null-assign/3	<com.matt_richardson.gocd.websocket_notifier.PluginConfig: void <init>()>/$stringconstant1
<com.matt_richardson.gocd.websocket_notifier.PluginConfig: void <init>()>/assign/2	<com.matt_richardson.gocd.websocket_notifier.PluginConfig: void <init>()>/$stack4
<com.matt_richardson.gocd.websocket_notifier.PluginConfig: void <init>()>/assign/3	<com.matt_richardson.gocd.websocket_notifier.PluginConfig: void <init>()>/$stack5
<com.matt_richardson.gocd.websocket_notifier.PluginConfig: void <init>()>/fresh-null-assign/4	<com.matt_richardson.gocd.websocket_notifier.PluginConfig: void <init>()>/$stringconstant2
<com.matt_richardson.gocd.websocket_notifier.PluginConfig: void <init>()>/assign/9	<com.matt_richardson.gocd.websocket_notifier.PluginConfig: void <init>()>/$stack30
<com.matt_richardson.gocd.websocket_notifier.PluginConfig: void <init>()>/fresh-null-assign/5	<com.matt_richardson.gocd.websocket_notifier.PluginConfig: void <init>()>/$stringconstant3
<com.matt_richardson.gocd.websocket_notifier.PluginConfig: void <init>()>/fresh-null-assign/6	<com.matt_richardson.gocd.websocket_notifier.PluginConfig: void <init>()>/$stringconstant4
<com.matt_richardson.gocd.websocket_notifier.PluginConfig: void <init>()>/fresh-null-assign/7	<com.matt_richardson.gocd.websocket_notifier.PluginConfig: void <init>()>/$stringconstant5
<com.matt_richardson.gocd.websocket_notifier.PluginConfig: void <init>()>/fresh-null-assign/8	<com.matt_richardson.gocd.websocket_notifier.PluginConfig: void <init>()>/$stringconstant6
<com.matt_richardson.gocd.websocket_notifier.PluginConfig: void <init>()>/fresh-null-assign/9	<com.matt_richardson.gocd.websocket_notifier.PluginConfig: void <init>()>/$stringconstant7
<com.matt_richardson.gocd.websocket_notifier.PluginConfig: void <init>()>/fresh-null-assign/10	<com.matt_richardson.gocd.websocket_notifier.PluginConfig: void <init>()>/$stringconstant8
<com.matt_richardson.gocd.websocket_notifier.PluginConfig: void <init>()>/fresh-null-assign/11	<com.matt_richardson.gocd.websocket_notifier.PluginConfig: void <init>()>/$stringconstant9
<com.matt_richardson.gocd.websocket_notifier.PluginConfig: void <init>()>/fresh-null-assign/12	<com.matt_richardson.gocd.websocket_notifier.PluginConfig: void <init>()>/$stringconstant10
<com.matt_richardson.gocd.websocket_notifier.PluginConfig: void <init>()>/fresh-null-assign/13	<com.matt_richardson.gocd.websocket_notifier.PluginConfig: void <init>()>/$stringconstant11
<com.matt_richardson.gocd.websocket_notifier.PluginConfig: void <init>()>/fresh-null-assign/14	<com.matt_richardson.gocd.websocket_notifier.PluginConfig: void <init>()>/$stringconstant12
<com.matt_richardson.gocd.websocket_notifier.PluginConfig: void <init>()>/fresh-null-assign/15	<com.matt_richardson.gocd.websocket_notifier.PluginConfig: void <init>()>/$stringconstant13
<com.matt_richardson.gocd.websocket_notifier.PluginConfig: void <init>()>/fresh-null-assign/16	<com.matt_richardson.gocd.websocket_notifier.PluginConfig: void <init>()>/$stringconstant14
<com.matt_richardson.gocd.websocket_notifier.PluginConfig: void <clinit>()>/fresh-null-assign/0	<com.matt_richardson.gocd.websocket_notifier.PluginConfig: void <clinit>()>/$classconstant0
<com.matt_richardson.gocd.websocket_notifier.WebSocketPipelineListener: void <init>(com.matt_richardson.gocd.websocket_notifier.PipelineWebSocketServer,com.matt_richardson.gocd.websocket_notifier.PluginConfig)>/fresh-null-assign/0	<com.matt_richardson.gocd.websocket_notifier.WebSocketPipelineListener: void <init>(com.matt_richardson.gocd.websocket_notifier.PipelineWebSocketServer,com.matt_richardson.gocd.websocket_notifier.PluginConfig)>/$classconstant0
<com.matt_richardson.gocd.websocket_notifier.WebSocketPipelineListener: void <init>(com.matt_richardson.gocd.websocket_notifier.PipelineWebSocketServer,com.matt_richardson.gocd.websocket_notifier.PluginConfig)>/assign/4	<com.matt_richardson.gocd.websocket_notifier.WebSocketPipelineListener: void <init>(com.matt_richardson.gocd.websocket_notifier.PipelineWebSocketServer,com.matt_richardson.gocd.websocket_notifier.PluginConfig)>/$stack4
<com.matt_richardson.gocd.websocket_notifier.WebSocketPipelineListener: void notify(com.thoughtworks.go.plugin.api.request.GoPluginApiRequest)>/assign/2	<com.matt_richardson.gocd.websocket_notifier.WebSocketPipelineListener: void notify(com.thoughtworks.go.plugin.api.request.GoPluginApiRequest)>/$stack3
<com.matt_richardson.gocd.websocket_notifier.WebSocketPipelineListener: void notify(com.thoughtworks.go.plugin.api.request.GoPluginApiRequest)>/fresh-null-assign/0	<com.matt_richardson.gocd.websocket_notifier.WebSocketPipelineListener: void notify(com.thoughtworks.go.plugin.api.request.GoPluginApiRequest)>/$stringconstant0
<com.matt_richardson.gocd.websocket_notifier.WebSocketPipelineListener: void notify(com.thoughtworks.go.plugin.api.request.GoPluginApiRequest)>/fresh-null-assign/1	<com.matt_richardson.gocd.websocket_notifier.WebSocketPipelineListener: void notify(com.thoughtworks.go.plugin.api.request.GoPluginApiRequest)>/$stringconstant1
<com.matt_richardson.gocd.websocket_notifier.WebSocketPipelineListener: void notify(com.thoughtworks.go.plugin.api.request.GoPluginApiRequest)>/fresh-null-assign/2	<com.matt_richardson.gocd.websocket_notifier.WebSocketPipelineListener: void notify(com.thoughtworks.go.plugin.api.request.GoPluginApiRequest)>/$stringconstant2
<com.matt_richardson.gocd.websocket_notifier.PipelineDetailsPopulator: java.lang.String mergeInPipelineInstanceDetails(com.google.gson.JsonElement,com.google.gson.JsonElement)>/fresh-null-assign/0	<com.matt_richardson.gocd.websocket_notifier.PipelineDetailsPopulator: java.lang.String mergeInPipelineInstanceDetails(com.google.gson.JsonElement,com.google.gson.JsonElement)>/$stringconstant0
<com.matt_richardson.gocd.websocket_notifier.PipelineDetailsPopulator: com.google.gson.JsonElement downloadPipelineInstanceDetails(java.lang.String)>/assign/3	<com.matt_richardson.gocd.websocket_notifier.PipelineDetailsPopulator: com.google.gson.JsonElement downloadPipelineInstanceDetails(java.lang.String)>/$stack11
<com.matt_richardson.gocd.websocket_notifier.PipelineDetailsPopulator: com.google.gson.JsonElement downloadPipelineInstanceDetails(java.lang.String)>/fresh-null-assign/0	<com.matt_richardson.gocd.websocket_notifier.PipelineDetailsPopulator: com.google.gson.JsonElement downloadPipelineInstanceDetails(java.lang.String)>/$stringconstant0
<com.matt_richardson.gocd.websocket_notifier.PipelineDetailsPopulator: com.google.gson.JsonElement downloadPipelineInstanceDetails(java.lang.String)>/fresh-null-assign/1	<com.matt_richardson.gocd.websocket_notifier.PipelineDetailsPopulator: com.google.gson.JsonElement downloadPipelineInstanceDetails(java.lang.String)>/$stringconstant1
<com.matt_richardson.gocd.websocket_notifier.PipelineDetailsPopulator: com.google.gson.JsonElement downloadPipelineInstanceDetails(java.lang.String)>/fresh-null-assign/2	<com.matt_richardson.gocd.websocket_notifier.PipelineDetailsPopulator: com.google.gson.JsonElement downloadPipelineInstanceDetails(java.lang.String)>/$stringconstant2
<com.matt_richardson.gocd.websocket_notifier.PipelineDetailsPopulator: com.google.gson.JsonElement downloadPipelineInstanceDetails(java.lang.String)>/assign/10	<com.matt_richardson.gocd.websocket_notifier.PipelineDetailsPopulator: com.google.gson.JsonElement downloadPipelineInstanceDetails(java.lang.String)>/$stack17
<com.matt_richardson.gocd.websocket_notifier.PipelineDetailsPopulator: com.google.gson.JsonElement downloadPipelineInstanceDetails(java.lang.String)>/assign/15	<com.matt_richardson.gocd.websocket_notifier.PipelineDetailsPopulator: com.google.gson.JsonElement downloadPipelineInstanceDetails(java.lang.String)>/$stack29
<com.matt_richardson.gocd.websocket_notifier.PipelineDetailsPopulator: com.google.gson.JsonElement downloadPipelineInstanceDetails(java.lang.String)>/fresh-null-assign/3	<com.matt_richardson.gocd.websocket_notifier.PipelineDetailsPopulator: com.google.gson.JsonElement downloadPipelineInstanceDetails(java.lang.String)>/$stringconstant3
<com.matt_richardson.gocd.websocket_notifier.PipelineDetailsPopulator: com.google.gson.JsonElement downloadPipelineInstanceDetails(java.lang.String)>/assign/20	<com.matt_richardson.gocd.websocket_notifier.PipelineDetailsPopulator: com.google.gson.JsonElement downloadPipelineInstanceDetails(java.lang.String)>/$stack33
<com.matt_richardson.gocd.websocket_notifier.PipelineDetailsPopulator: com.google.gson.JsonElement downloadPipelineInstanceDetails(java.lang.String)>/assign/23	<com.matt_richardson.gocd.websocket_notifier.PipelineDetailsPopulator: com.google.gson.JsonElement downloadPipelineInstanceDetails(java.lang.String)>/$stack36
<com.matt_richardson.gocd.websocket_notifier.PipelineDetailsPopulator: com.google.gson.JsonElement downloadPipelineInstanceDetails(java.lang.String)>/fresh-null-assign/4	<com.matt_richardson.gocd.websocket_notifier.PipelineDetailsPopulator: com.google.gson.JsonElement downloadPipelineInstanceDetails(java.lang.String)>/$stringconstant4
<com.matt_richardson.gocd.websocket_notifier.PipelineDetailsPopulator: com.google.gson.JsonElement downloadPipelineInstanceDetails(java.lang.String)>/fresh-null-assign/5	<com.matt_richardson.gocd.websocket_notifier.PipelineDetailsPopulator: com.google.gson.JsonElement downloadPipelineInstanceDetails(java.lang.String)>/$stringconstant5
<com.matt_richardson.gocd.websocket_notifier.PipelineDetailsPopulator: com.google.gson.JsonElement downloadPipelineInstanceDetails(java.lang.String)>/assign/27	<com.matt_richardson.gocd.websocket_notifier.PipelineDetailsPopulator: com.google.gson.JsonElement downloadPipelineInstanceDetails(java.lang.String)>/$stack21
<com.matt_richardson.gocd.websocket_notifier.PipelineDetailsPopulator: com.google.gson.JsonElement downloadPipelineInstanceDetails(java.lang.String)>/assign/28	<com.matt_richardson.gocd.websocket_notifier.PipelineDetailsPopulator: com.google.gson.JsonElement downloadPipelineInstanceDetails(java.lang.String)>/$stack22
<com.matt_richardson.gocd.websocket_notifier.PipelineDetailsPopulator: com.google.gson.JsonElement downloadPipelineInstanceDetails(java.lang.String)>/fresh-null-assign/6	<com.matt_richardson.gocd.websocket_notifier.PipelineDetailsPopulator: com.google.gson.JsonElement downloadPipelineInstanceDetails(java.lang.String)>/$stringconstant6
<com.matt_richardson.gocd.websocket_notifier.PipelineDetailsPopulator: java.lang.String extendMessageToIncludePipelineDetails(java.lang.String)>/assign/2	<com.matt_richardson.gocd.websocket_notifier.PipelineDetailsPopulator: java.lang.String extendMessageToIncludePipelineDetails(java.lang.String)>/$u0
<com.matt_richardson.gocd.websocket_notifier.PipelineDetailsPopulator: java.lang.String extendMessageToIncludePipelineDetails(java.lang.String)>/fresh-null-assign/0	<com.matt_richardson.gocd.websocket_notifier.PipelineDetailsPopulator: java.lang.String extendMessageToIncludePipelineDetails(java.lang.String)>/$stringconstant0
<com.matt_richardson.gocd.websocket_notifier.PipelineDetailsPopulator: java.lang.String extendMessageToIncludePipelineDetails(java.lang.String)>/fresh-null-assign/1	<com.matt_richardson.gocd.websocket_notifier.PipelineDetailsPopulator: java.lang.String extendMessageToIncludePipelineDetails(java.lang.String)>/$stringconstant1
<com.matt_richardson.gocd.websocket_notifier.PipelineDetailsPopulator: java.lang.String extendMessageToIncludePipelineDetails(java.lang.String)>/fresh-null-assign/2	<com.matt_richardson.gocd.websocket_notifier.PipelineDetailsPopulator: java.lang.String extendMessageToIncludePipelineDetails(java.lang.String)>/$stringconstant2
<com.matt_richardson.gocd.websocket_notifier.PipelineDetailsPopulator: java.lang.String extendMessageToIncludePipelineDetails(java.lang.String)>/assign/17	<com.matt_richardson.gocd.websocket_notifier.PipelineDetailsPopulator: java.lang.String extendMessageToIncludePipelineDetails(java.lang.String)>/$u1
<com.matt_richardson.gocd.websocket_notifier.PipelineDetailsPopulator: java.lang.String extendMessageToIncludePipelineDetails(java.lang.String)>/fresh-null-assign/3	<com.matt_richardson.gocd.websocket_notifier.PipelineDetailsPopulator: java.lang.String extendMessageToIncludePipelineDetails(java.lang.String)>/$stringconstant3
<com.matt_richardson.gocd.websocket_notifier.PipelineDetailsPopulator: java.lang.String extendMessageToIncludePipelineDetails(java.lang.String)>/fresh-null-assign/4	<com.matt_richardson.gocd.websocket_notifier.PipelineDetailsPopulator: java.lang.String extendMessageToIncludePipelineDetails(java.lang.String)>/$stringconstant4
<com.matt_richardson.gocd.websocket_notifier.PipelineDetailsPopulator: void <clinit>()>/fresh-null-assign/0	<com.matt_richardson.gocd.websocket_notifier.PipelineDetailsPopulator: void <clinit>()>/$classconstant0
<com.matt_richardson.gocd.websocket_notifier.PipelineWebSocketServer: void <init>(int)>/assign/0	<com.matt_richardson.gocd.websocket_notifier.PipelineWebSocketServer: void <init>(int)>/this#_0
<com.matt_richardson.gocd.websocket_notifier.PipelineWebSocketServer: void <init>(int)>/assign/1	<com.matt_richardson.gocd.websocket_notifier.PipelineWebSocketServer: void <init>(int)>/port#_0
<com.matt_richardson.gocd.websocket_notifier.PipelineWebSocketServer: void <init>(java.lang.String,int)>/assign/0	<com.matt_richardson.gocd.websocket_notifier.PipelineWebSocketServer: void <init>(java.lang.String,int)>/this#_0
<com.matt_richardson.gocd.websocket_notifier.PipelineWebSocketServer: void <init>(java.lang.String,int)>/assign/1	<com.matt_richardson.gocd.websocket_notifier.PipelineWebSocketServer: void <init>(java.lang.String,int)>/host#_0
<com.matt_richardson.gocd.websocket_notifier.PipelineWebSocketServer: void <init>(java.lang.String,int)>/assign/2	<com.matt_richardson.gocd.websocket_notifier.PipelineWebSocketServer: void <init>(java.lang.String,int)>/port#_0
<com.matt_richardson.gocd.websocket_notifier.PipelineWebSocketServer: void onOpen(org.java_websocket.WebSocket,org.java_websocket.handshake.ClientHandshake)>/assign/0	<com.matt_richardson.gocd.websocket_notifier.PipelineWebSocketServer: void onOpen(org.java_websocket.WebSocket,org.java_websocket.handshake.ClientHandshake)>/this#_0
<com.matt_richardson.gocd.websocket_notifier.PipelineWebSocketServer: void onOpen(org.java_websocket.WebSocket,org.java_websocket.handshake.ClientHandshake)>/assign/1	<com.matt_richardson.gocd.websocket_notifier.PipelineWebSocketServer: void onOpen(org.java_websocket.WebSocket,org.java_websocket.handshake.ClientHandshake)>/conn#_0
<com.matt_richardson.gocd.websocket_notifier.PipelineWebSocketServer: void onOpen(org.java_websocket.WebSocket,org.java_websocket.handshake.ClientHandshake)>/assign/2	<com.matt_richardson.gocd.websocket_notifier.PipelineWebSocketServer: void onOpen(org.java_websocket.WebSocket,org.java_websocket.handshake.ClientHandshake)>/handshake#_0
<com.matt_richardson.gocd.websocket_notifier.PipelineWebSocketServer: void onClose(org.java_websocket.WebSocket,int,java.lang.String,boolean)>/assign/0	<com.matt_richardson.gocd.websocket_notifier.PipelineWebSocketServer: void onClose(org.java_websocket.WebSocket,int,java.lang.String,boolean)>/this#_0
<com.matt_richardson.gocd.websocket_notifier.PipelineWebSocketServer: void onClose(org.java_websocket.WebSocket,int,java.lang.String,boolean)>/assign/1	<com.matt_richardson.gocd.websocket_notifier.PipelineWebSocketServer: void onClose(org.java_websocket.WebSocket,int,java.lang.String,boolean)>/conn#_0
<com.matt_richardson.gocd.websocket_notifier.PipelineWebSocketServer: void onClose(org.java_websocket.WebSocket,int,java.lang.String,boolean)>/assign/2	<com.matt_richardson.gocd.websocket_notifier.PipelineWebSocketServer: void onClose(org.java_websocket.WebSocket,int,java.lang.String,boolean)>/code#_0
<com.matt_richardson.gocd.websocket_notifier.PipelineWebSocketServer: void onClose(org.java_websocket.WebSocket,int,java.lang.String,boolean)>/assign/3	<com.matt_richardson.gocd.websocket_notifier.PipelineWebSocketServer: void onClose(org.java_websocket.WebSocket,int,java.lang.String,boolean)>/reason#_0
<com.matt_richardson.gocd.websocket_notifier.PipelineWebSocketServer: void onClose(org.java_websocket.WebSocket,int,java.lang.String,boolean)>/assign/4	<com.matt_richardson.gocd.websocket_notifier.PipelineWebSocketServer: void onClose(org.java_websocket.WebSocket,int,java.lang.String,boolean)>/remote#_0
<com.matt_richardson.gocd.websocket_notifier.PipelineWebSocketServer: void onMessage(org.java_websocket.WebSocket,java.lang.String)>/assign/0	<com.matt_richardson.gocd.websocket_notifier.PipelineWebSocketServer: void onMessage(org.java_websocket.WebSocket,java.lang.String)>/this#_0
<com.matt_richardson.gocd.websocket_notifier.PipelineWebSocketServer: void onMessage(org.java_websocket.WebSocket,java.lang.String)>/assign/1	<com.matt_richardson.gocd.websocket_notifier.PipelineWebSocketServer: void onMessage(org.java_websocket.WebSocket,java.lang.String)>/conn#_0
<com.matt_richardson.gocd.websocket_notifier.PipelineWebSocketServer: void onMessage(org.java_websocket.WebSocket,java.lang.String)>/assign/2	<com.matt_richardson.gocd.websocket_notifier.PipelineWebSocketServer: void onMessage(org.java_websocket.WebSocket,java.lang.String)>/message#_0
<com.matt_richardson.gocd.websocket_notifier.PipelineWebSocketServer: void onError(org.java_websocket.WebSocket,java.lang.Exception)>/assign/0	<com.matt_richardson.gocd.websocket_notifier.PipelineWebSocketServer: void onError(org.java_websocket.WebSocket,java.lang.Exception)>/this#_0
<com.matt_richardson.gocd.websocket_notifier.PipelineWebSocketServer: void onError(org.java_websocket.WebSocket,java.lang.Exception)>/assign/1	<com.matt_richardson.gocd.websocket_notifier.PipelineWebSocketServer: void onError(org.java_websocket.WebSocket,java.lang.Exception)>/conn#_0
<com.matt_richardson.gocd.websocket_notifier.PipelineWebSocketServer: void onError(org.java_websocket.WebSocket,java.lang.Exception)>/assign/2	<com.matt_richardson.gocd.websocket_notifier.PipelineWebSocketServer: void onError(org.java_websocket.WebSocket,java.lang.Exception)>/ex#_0
<com.matt_richardson.gocd.websocket_notifier.PipelineWebSocketServer: void sendToAll(java.lang.String)>/assign/0	<com.matt_richardson.gocd.websocket_notifier.PipelineWebSocketServer: void sendToAll(java.lang.String)>/this#_0
<com.matt_richardson.gocd.websocket_notifier.PipelineWebSocketServer: void sendToAll(java.lang.String)>/assign/1	<com.matt_richardson.gocd.websocket_notifier.PipelineWebSocketServer: void sendToAll(java.lang.String)>/text#_0
<com.matt_richardson.gocd.websocket_notifier.GoNotificationPlugin: void initializeGoApplicationAccessor(com.thoughtworks.go.plugin.api.GoApplicationAccessor)>/assign/0	<com.matt_richardson.gocd.websocket_notifier.GoNotificationPlugin: void initializeGoApplicationAccessor(com.thoughtworks.go.plugin.api.GoApplicationAccessor)>/this#_0
<com.matt_richardson.gocd.websocket_notifier.GoNotificationPlugin: void initializeGoApplicationAccessor(com.thoughtworks.go.plugin.api.GoApplicationAccessor)>/assign/1	<com.matt_richardson.gocd.websocket_notifier.GoNotificationPlugin: void initializeGoApplicationAccessor(com.thoughtworks.go.plugin.api.GoApplicationAccessor)>/goApplicationAccessor#_0
<com.matt_richardson.gocd.websocket_notifier.GoNotificationPlugin: void initializeGoApplicationAccessor(com.thoughtworks.go.plugin.api.GoApplicationAccessor)>/assign/11	<com.matt_richardson.gocd.websocket_notifier.GoNotificationPlugin: void initializeGoApplicationAccessor(com.thoughtworks.go.plugin.api.GoApplicationAccessor)>/s#_38
<com.matt_richardson.gocd.websocket_notifier.GoNotificationPlugin: void initializeGoApplicationAccessor(com.thoughtworks.go.plugin.api.GoApplicationAccessor)>/assign/13	<com.matt_richardson.gocd.websocket_notifier.GoNotificationPlugin: void initializeGoApplicationAccessor(com.thoughtworks.go.plugin.api.GoApplicationAccessor)>/s_$$A_1#_40
<com.matt_richardson.gocd.websocket_notifier.GoNotificationPlugin: void initializeGoApplicationAccessor(com.thoughtworks.go.plugin.api.GoApplicationAccessor)>/phi-assign/0	<com.matt_richardson.gocd.websocket_notifier.GoNotificationPlugin: void initializeGoApplicationAccessor(com.thoughtworks.go.plugin.api.GoApplicationAccessor)>/s_$$A_2#_41
<com.matt_richardson.gocd.websocket_notifier.GoNotificationPlugin: void initializeGoApplicationAccessor(com.thoughtworks.go.plugin.api.GoApplicationAccessor)>/phi-assign/1	<com.matt_richardson.gocd.websocket_notifier.GoNotificationPlugin: void initializeGoApplicationAccessor(com.thoughtworks.go.plugin.api.GoApplicationAccessor)>/s_$$A_2#_41
<com.matt_richardson.gocd.websocket_notifier.GoNotificationPlugin: void initializeGoApplicationAccessor(com.thoughtworks.go.plugin.api.GoApplicationAccessor)>/phi-assign/2	<com.matt_richardson.gocd.websocket_notifier.GoNotificationPlugin: void initializeGoApplicationAccessor(com.thoughtworks.go.plugin.api.GoApplicationAccessor)>/s_$$A_3#_48
<com.matt_richardson.gocd.websocket_notifier.GoNotificationPlugin: void initializeGoApplicationAccessor(com.thoughtworks.go.plugin.api.GoApplicationAccessor)>/phi-assign/3	<com.matt_richardson.gocd.websocket_notifier.GoNotificationPlugin: void initializeGoApplicationAccessor(com.thoughtworks.go.plugin.api.GoApplicationAccessor)>/s_$$A_3#_48
<com.matt_richardson.gocd.websocket_notifier.GoNotificationPlugin: void initializeGoApplicationAccessor(com.thoughtworks.go.plugin.api.GoApplicationAccessor)>/phi-assign/4	<com.matt_richardson.gocd.websocket_notifier.GoNotificationPlugin: void initializeGoApplicationAccessor(com.thoughtworks.go.plugin.api.GoApplicationAccessor)>/s_$$A_3#_48
<com.matt_richardson.gocd.websocket_notifier.GoNotificationPlugin: void initializeGoApplicationAccessor(com.thoughtworks.go.plugin.api.GoApplicationAccessor)>/phi-assign/5	<com.matt_richardson.gocd.websocket_notifier.GoNotificationPlugin: void initializeGoApplicationAccessor(com.thoughtworks.go.plugin.api.GoApplicationAccessor)>/s_$$A_4#_47
<com.matt_richardson.gocd.websocket_notifier.GoNotificationPlugin: void initializeGoApplicationAccessor(com.thoughtworks.go.plugin.api.GoApplicationAccessor)>/phi-assign/6	<com.matt_richardson.gocd.websocket_notifier.GoNotificationPlugin: void initializeGoApplicationAccessor(com.thoughtworks.go.plugin.api.GoApplicationAccessor)>/s_$$A_4#_47
<com.matt_richardson.gocd.websocket_notifier.GoNotificationPlugin: void initializeGoApplicationAccessor(com.thoughtworks.go.plugin.api.GoApplicationAccessor)>/phi-assign/7	<com.matt_richardson.gocd.websocket_notifier.GoNotificationPlugin: void initializeGoApplicationAccessor(com.thoughtworks.go.plugin.api.GoApplicationAccessor)>/s_$$A_4#_47
<com.matt_richardson.gocd.websocket_notifier.GoNotificationPlugin: void <init>()>/assign/0	<com.matt_richardson.gocd.websocket_notifier.GoNotificationPlugin: void <init>()>/this#_0
<com.matt_richardson.gocd.websocket_notifier.GoNotificationPlugin: void <init>(com.matt_richardson.gocd.websocket_notifier.WebSocketPipelineListener)>/assign/0	<com.matt_richardson.gocd.websocket_notifier.GoNotificationPlugin: void <init>(com.matt_richardson.gocd.websocket_notifier.WebSocketPipelineListener)>/this#_0
<com.matt_richardson.gocd.websocket_notifier.GoNotificationPlugin: void <init>(com.matt_richardson.gocd.websocket_notifier.WebSocketPipelineListener)>/assign/1	<com.matt_richardson.gocd.websocket_notifier.GoNotificationPlugin: void <init>(com.matt_richardson.gocd.websocket_notifier.WebSocketPipelineListener)>/pipelineListener#_0
<com.matt_richardson.gocd.websocket_notifier.GoNotificationPlugin: com.thoughtworks.go.plugin.api.response.GoPluginApiResponse handle(com.thoughtworks.go.plugin.api.request.GoPluginApiRequest)>/assign/0	<com.matt_richardson.gocd.websocket_notifier.GoNotificationPlugin: com.thoughtworks.go.plugin.api.response.GoPluginApiResponse handle(com.thoughtworks.go.plugin.api.request.GoPluginApiRequest)>/this#_0
<com.matt_richardson.gocd.websocket_notifier.GoNotificationPlugin: com.thoughtworks.go.plugin.api.response.GoPluginApiResponse handle(com.thoughtworks.go.plugin.api.request.GoPluginApiRequest)>/assign/1	<com.matt_richardson.gocd.websocket_notifier.GoNotificationPlugin: com.thoughtworks.go.plugin.api.response.GoPluginApiResponse handle(com.thoughtworks.go.plugin.api.request.GoPluginApiRequest)>/goPluginApiRequest#_0
<com.matt_richardson.gocd.websocket_notifier.GoNotificationPlugin: com.thoughtworks.go.plugin.api.GoPluginIdentifier pluginIdentifier()>/assign/0	<com.matt_richardson.gocd.websocket_notifier.GoNotificationPlugin: com.thoughtworks.go.plugin.api.GoPluginIdentifier pluginIdentifier()>/this#_0
<com.matt_richardson.gocd.websocket_notifier.GoNotificationPlugin: com.thoughtworks.go.plugin.api.response.GoPluginApiResponse handleNotificationsInterestedIn()>/assign/0	<com.matt_richardson.gocd.websocket_notifier.GoNotificationPlugin: com.thoughtworks.go.plugin.api.response.GoPluginApiResponse handleNotificationsInterestedIn()>/this#_0
<com.matt_richardson.gocd.websocket_notifier.GoNotificationPlugin: com.thoughtworks.go.plugin.api.response.GoPluginApiResponse handleStageNotification(com.thoughtworks.go.plugin.api.request.GoPluginApiRequest)>/assign/0	<com.matt_richardson.gocd.websocket_notifier.GoNotificationPlugin: com.thoughtworks.go.plugin.api.response.GoPluginApiResponse handleStageNotification(com.thoughtworks.go.plugin.api.request.GoPluginApiRequest)>/this#_0
<com.matt_richardson.gocd.websocket_notifier.GoNotificationPlugin: com.thoughtworks.go.plugin.api.response.GoPluginApiResponse handleStageNotification(com.thoughtworks.go.plugin.api.request.GoPluginApiRequest)>/assign/1	<com.matt_richardson.gocd.websocket_notifier.GoNotificationPlugin: com.thoughtworks.go.plugin.api.response.GoPluginApiResponse handleStageNotification(com.thoughtworks.go.plugin.api.request.GoPluginApiRequest)>/goPluginApiRequest#_0
<com.matt_richardson.gocd.websocket_notifier.GoNotificationPlugin: com.thoughtworks.go.plugin.api.response.GoPluginApiResponse handleStageNotification(com.thoughtworks.go.plugin.api.request.GoPluginApiRequest)>/phi-assign/0	<com.matt_richardson.gocd.websocket_notifier.GoNotificationPlugin: com.thoughtworks.go.plugin.api.response.GoPluginApiResponse handleStageNotification(com.thoughtworks.go.plugin.api.request.GoPluginApiRequest)>/responseCode_$$A_2#_101
<com.matt_richardson.gocd.websocket_notifier.GoNotificationPlugin: com.thoughtworks.go.plugin.api.response.GoPluginApiResponse handleStageNotification(com.thoughtworks.go.plugin.api.request.GoPluginApiRequest)>/phi-assign/1	<com.matt_richardson.gocd.websocket_notifier.GoNotificationPlugin: com.thoughtworks.go.plugin.api.response.GoPluginApiResponse handleStageNotification(com.thoughtworks.go.plugin.api.request.GoPluginApiRequest)>/responseCode_$$A_2#_101
<com.matt_richardson.gocd.websocket_notifier.GoNotificationPlugin: com.thoughtworks.go.plugin.api.response.GoPluginApiResponse renderJSON(int,java.lang.Object)>/assign/0	<com.matt_richardson.gocd.websocket_notifier.GoNotificationPlugin: com.thoughtworks.go.plugin.api.response.GoPluginApiResponse renderJSON(int,java.lang.Object)>/this#_0
<com.matt_richardson.gocd.websocket_notifier.GoNotificationPlugin: com.thoughtworks.go.plugin.api.response.GoPluginApiResponse renderJSON(int,java.lang.Object)>/assign/1	<com.matt_richardson.gocd.websocket_notifier.GoNotificationPlugin: com.thoughtworks.go.plugin.api.response.GoPluginApiResponse renderJSON(int,java.lang.Object)>/responseCode#_0
<com.matt_richardson.gocd.websocket_notifier.GoNotificationPlugin: com.thoughtworks.go.plugin.api.response.GoPluginApiResponse renderJSON(int,java.lang.Object)>/assign/2	<com.matt_richardson.gocd.websocket_notifier.GoNotificationPlugin: com.thoughtworks.go.plugin.api.response.GoPluginApiResponse renderJSON(int,java.lang.Object)>/response#_0
<com.matt_richardson.gocd.websocket_notifier.GoNotificationPlugin: com.thoughtworks.go.plugin.api.response.GoPluginApiResponse renderJSON(int,java.lang.Object)>/phi-assign/0	<com.matt_richardson.gocd.websocket_notifier.GoNotificationPlugin: com.thoughtworks.go.plugin.api.response.GoPluginApiResponse renderJSON(int,java.lang.Object)>/$stack7_$$A_2
<com.matt_richardson.gocd.websocket_notifier.GoNotificationPlugin: com.thoughtworks.go.plugin.api.response.GoPluginApiResponse renderJSON(int,java.lang.Object)>/phi-assign/1	<com.matt_richardson.gocd.websocket_notifier.GoNotificationPlugin: com.thoughtworks.go.plugin.api.response.GoPluginApiResponse renderJSON(int,java.lang.Object)>/$stack7_$$A_2
<com.matt_richardson.gocd.websocket_notifier.GoNotificationPlugin$1: void <init>(com.matt_richardson.gocd.websocket_notifier.GoNotificationPlugin,int,java.lang.String)>/assign/0	<com.matt_richardson.gocd.websocket_notifier.GoNotificationPlugin$1: void <init>(com.matt_richardson.gocd.websocket_notifier.GoNotificationPlugin,int,java.lang.String)>/this#_0
<com.matt_richardson.gocd.websocket_notifier.GoNotificationPlugin$1: void <init>(com.matt_richardson.gocd.websocket_notifier.GoNotificationPlugin,int,java.lang.String)>/assign/1	<com.matt_richardson.gocd.websocket_notifier.GoNotificationPlugin$1: void <init>(com.matt_richardson.gocd.websocket_notifier.GoNotificationPlugin,int,java.lang.String)>/this$0#_0
<com.matt_richardson.gocd.websocket_notifier.GoNotificationPlugin$1: void <init>(com.matt_richardson.gocd.websocket_notifier.GoNotificationPlugin,int,java.lang.String)>/assign/2	<com.matt_richardson.gocd.websocket_notifier.GoNotificationPlugin$1: void <init>(com.matt_richardson.gocd.websocket_notifier.GoNotificationPlugin,int,java.lang.String)>/l2#_0
<com.matt_richardson.gocd.websocket_notifier.GoNotificationPlugin$1: void <init>(com.matt_richardson.gocd.websocket_notifier.GoNotificationPlugin,int,java.lang.String)>/assign/3	<com.matt_richardson.gocd.websocket_notifier.GoNotificationPlugin$1: void <init>(com.matt_richardson.gocd.websocket_notifier.GoNotificationPlugin,int,java.lang.String)>/l3#_0
<com.matt_richardson.gocd.websocket_notifier.GoNotificationPlugin$1: int responseCode()>/assign/0	<com.matt_richardson.gocd.websocket_notifier.GoNotificationPlugin$1: int responseCode()>/this#_0
<com.matt_richardson.gocd.websocket_notifier.GoNotificationPlugin$1: java.util.Map responseHeaders()>/assign/0	<com.matt_richardson.gocd.websocket_notifier.GoNotificationPlugin$1: java.util.Map responseHeaders()>/this#_0
<com.matt_richardson.gocd.websocket_notifier.GoNotificationPlugin$1: java.lang.String responseBody()>/assign/0	<com.matt_richardson.gocd.websocket_notifier.GoNotificationPlugin$1: java.lang.String responseBody()>/this#_0
<com.matt_richardson.gocd.websocket_notifier.PluginConfig: void <init>()>/assign/0	<com.matt_richardson.gocd.websocket_notifier.PluginConfig: void <init>()>/this#_0
<com.matt_richardson.gocd.websocket_notifier.PluginConfig: int getPort()>/assign/0	<com.matt_richardson.gocd.websocket_notifier.PluginConfig: int getPort()>/this#_0
<com.matt_richardson.gocd.websocket_notifier.PluginConfig: void setPort(int)>/assign/0	<com.matt_richardson.gocd.websocket_notifier.PluginConfig: void setPort(int)>/this#_0
<com.matt_richardson.gocd.websocket_notifier.PluginConfig: void setPort(int)>/assign/1	<com.matt_richardson.gocd.websocket_notifier.PluginConfig: void setPort(int)>/port#_0
<com.matt_richardson.gocd.websocket_notifier.PluginConfig: java.lang.String getHost()>/assign/0	<com.matt_richardson.gocd.websocket_notifier.PluginConfig: java.lang.String getHost()>/this#_0
<com.matt_richardson.gocd.websocket_notifier.PluginConfig: void setHost(java.lang.String)>/assign/0	<com.matt_richardson.gocd.websocket_notifier.PluginConfig: void setHost(java.lang.String)>/this#_0
<com.matt_richardson.gocd.websocket_notifier.PluginConfig: void setHost(java.lang.String)>/assign/1	<com.matt_richardson.gocd.websocket_notifier.PluginConfig: void setHost(java.lang.String)>/host#_0
<com.matt_richardson.gocd.websocket_notifier.PluginConfig: boolean isHostSet()>/assign/0	<com.matt_richardson.gocd.websocket_notifier.PluginConfig: boolean isHostSet()>/this#_0
<com.matt_richardson.gocd.websocket_notifier.PluginConfig: boolean isHostSet()>/phi-assign/0	<com.matt_richardson.gocd.websocket_notifier.PluginConfig: boolean isHostSet()>/$stack3_$$A_2
<com.matt_richardson.gocd.websocket_notifier.PluginConfig: boolean isHostSet()>/phi-assign/1	<com.matt_richardson.gocd.websocket_notifier.PluginConfig: boolean isHostSet()>/$stack3_$$A_2
<com.matt_richardson.gocd.websocket_notifier.PluginConfig: int getGoHttpPort()>/assign/0	<com.matt_richardson.gocd.websocket_notifier.PluginConfig: int getGoHttpPort()>/this#_0
<com.matt_richardson.gocd.websocket_notifier.PluginConfig: void setGoHttpPort(int)>/assign/0	<com.matt_richardson.gocd.websocket_notifier.PluginConfig: void setGoHttpPort(int)>/this#_0
<com.matt_richardson.gocd.websocket_notifier.PluginConfig: void setGoHttpPort(int)>/assign/1	<com.matt_richardson.gocd.websocket_notifier.PluginConfig: void setGoHttpPort(int)>/port#_0
<com.matt_richardson.gocd.websocket_notifier.PluginConfig: java.lang.String getGoUser()>/assign/0	<com.matt_richardson.gocd.websocket_notifier.PluginConfig: java.lang.String getGoUser()>/this#_0
<com.matt_richardson.gocd.websocket_notifier.PluginConfig: void setGoUser(java.lang.String)>/assign/0	<com.matt_richardson.gocd.websocket_notifier.PluginConfig: void setGoUser(java.lang.String)>/this#_0
<com.matt_richardson.gocd.websocket_notifier.PluginConfig: void setGoUser(java.lang.String)>/assign/1	<com.matt_richardson.gocd.websocket_notifier.PluginConfig: void setGoUser(java.lang.String)>/user#_0
<com.matt_richardson.gocd.websocket_notifier.PluginConfig: boolean isGoUserSet()>/assign/0	<com.matt_richardson.gocd.websocket_notifier.PluginConfig: boolean isGoUserSet()>/this#_0
<com.matt_richardson.gocd.websocket_notifier.PluginConfig: boolean isGoUserSet()>/phi-assign/0	<com.matt_richardson.gocd.websocket_notifier.PluginConfig: boolean isGoUserSet()>/$stack2_$$A_2
<com.matt_richardson.gocd.websocket_notifier.PluginConfig: boolean isGoUserSet()>/phi-assign/1	<com.matt_richardson.gocd.websocket_notifier.PluginConfig: boolean isGoUserSet()>/$stack2_$$A_2
<com.matt_richardson.gocd.websocket_notifier.PluginConfig: java.lang.String getGoPassword()>/assign/0	<com.matt_richardson.gocd.websocket_notifier.PluginConfig: java.lang.String getGoPassword()>/this#_0
<com.matt_richardson.gocd.websocket_notifier.PluginConfig: void setGoPassword(java.lang.String)>/assign/0	<com.matt_richardson.gocd.websocket_notifier.PluginConfig: void setGoPassword(java.lang.String)>/this#_0
<com.matt_richardson.gocd.websocket_notifier.PluginConfig: void setGoPassword(java.lang.String)>/assign/1	<com.matt_richardson.gocd.websocket_notifier.PluginConfig: void setGoPassword(java.lang.String)>/password#_0
<com.matt_richardson.gocd.websocket_notifier.PluginConfig: boolean isGoPasswordSet()>/assign/0	<com.matt_richardson.gocd.websocket_notifier.PluginConfig: boolean isGoPasswordSet()>/this#_0
<com.matt_richardson.gocd.websocket_notifier.PluginConfig: boolean isGoPasswordSet()>/phi-assign/0	<com.matt_richardson.gocd.websocket_notifier.PluginConfig: boolean isGoPasswordSet()>/$stack2_$$A_2
<com.matt_richardson.gocd.websocket_notifier.PluginConfig: boolean isGoPasswordSet()>/phi-assign/1	<com.matt_richardson.gocd.websocket_notifier.PluginConfig: boolean isGoPasswordSet()>/$stack2_$$A_2
<com.matt_richardson.gocd.websocket_notifier.PluginConfig: boolean hasBasicAuth()>/assign/0	<com.matt_richardson.gocd.websocket_notifier.PluginConfig: boolean hasBasicAuth()>/this#_0
<com.matt_richardson.gocd.websocket_notifier.PluginConfig: boolean hasBasicAuth()>/phi-assign/0	<com.matt_richardson.gocd.websocket_notifier.PluginConfig: boolean hasBasicAuth()>/$stack3_$$A_2
<com.matt_richardson.gocd.websocket_notifier.PluginConfig: boolean hasBasicAuth()>/phi-assign/1	<com.matt_richardson.gocd.websocket_notifier.PluginConfig: boolean hasBasicAuth()>/$stack3_$$A_2
<com.matt_richardson.gocd.websocket_notifier.WebSocketPipelineListener: void <init>(com.matt_richardson.gocd.websocket_notifier.PipelineWebSocketServer,com.matt_richardson.gocd.websocket_notifier.PluginConfig)>/assign/0	<com.matt_richardson.gocd.websocket_notifier.WebSocketPipelineListener: void <init>(com.matt_richardson.gocd.websocket_notifier.PipelineWebSocketServer,com.matt_richardson.gocd.websocket_notifier.PluginConfig)>/this#_0
<com.matt_richardson.gocd.websocket_notifier.WebSocketPipelineListener: void <init>(com.matt_richardson.gocd.websocket_notifier.PipelineWebSocketServer,com.matt_richardson.gocd.websocket_notifier.PluginConfig)>/assign/1	<com.matt_richardson.gocd.websocket_notifier.WebSocketPipelineListener: void <init>(com.matt_richardson.gocd.websocket_notifier.PipelineWebSocketServer,com.matt_richardson.gocd.websocket_notifier.PluginConfig)>/webSocketServer#_0
<com.matt_richardson.gocd.websocket_notifier.WebSocketPipelineListener: void <init>(com.matt_richardson.gocd.websocket_notifier.PipelineWebSocketServer,com.matt_richardson.gocd.websocket_notifier.PluginConfig)>/assign/2	<com.matt_richardson.gocd.websocket_notifier.WebSocketPipelineListener: void <init>(com.matt_richardson.gocd.websocket_notifier.PipelineWebSocketServer,com.matt_richardson.gocd.websocket_notifier.PluginConfig)>/pluginConfig#_0
<com.matt_richardson.gocd.websocket_notifier.WebSocketPipelineListener: void notify(com.thoughtworks.go.plugin.api.request.GoPluginApiRequest)>/assign/0	<com.matt_richardson.gocd.websocket_notifier.WebSocketPipelineListener: void notify(com.thoughtworks.go.plugin.api.request.GoPluginApiRequest)>/this#_0
<com.matt_richardson.gocd.websocket_notifier.WebSocketPipelineListener: void notify(com.thoughtworks.go.plugin.api.request.GoPluginApiRequest)>/assign/1	<com.matt_richardson.gocd.websocket_notifier.WebSocketPipelineListener: void notify(com.thoughtworks.go.plugin.api.request.GoPluginApiRequest)>/message#_0
<com.matt_richardson.gocd.websocket_notifier.PipelineDetailsPopulator: void <init>(com.matt_richardson.gocd.websocket_notifier.PluginConfig)>/assign/0	<com.matt_richardson.gocd.websocket_notifier.PipelineDetailsPopulator: void <init>(com.matt_richardson.gocd.websocket_notifier.PluginConfig)>/this#_0
<com.matt_richardson.gocd.websocket_notifier.PipelineDetailsPopulator: void <init>(com.matt_richardson.gocd.websocket_notifier.PluginConfig)>/assign/1	<com.matt_richardson.gocd.websocket_notifier.PipelineDetailsPopulator: void <init>(com.matt_richardson.gocd.websocket_notifier.PluginConfig)>/pluginConfig#_0
<com.matt_richardson.gocd.websocket_notifier.PipelineDetailsPopulator: java.lang.String mergeInPipelineInstanceDetails(com.google.gson.JsonElement,com.google.gson.JsonElement)>/assign/0	<com.matt_richardson.gocd.websocket_notifier.PipelineDetailsPopulator: java.lang.String mergeInPipelineInstanceDetails(com.google.gson.JsonElement,com.google.gson.JsonElement)>/this#_0
<com.matt_richardson.gocd.websocket_notifier.PipelineDetailsPopulator: java.lang.String mergeInPipelineInstanceDetails(com.google.gson.JsonElement,com.google.gson.JsonElement)>/assign/1	<com.matt_richardson.gocd.websocket_notifier.PipelineDetailsPopulator: java.lang.String mergeInPipelineInstanceDetails(com.google.gson.JsonElement,com.google.gson.JsonElement)>/notification#_0
<com.matt_richardson.gocd.websocket_notifier.PipelineDetailsPopulator: java.lang.String mergeInPipelineInstanceDetails(com.google.gson.JsonElement,com.google.gson.JsonElement)>/assign/2	<com.matt_richardson.gocd.websocket_notifier.PipelineDetailsPopulator: java.lang.String mergeInPipelineInstanceDetails(com.google.gson.JsonElement,com.google.gson.JsonElement)>/pipelineInstance#_0
<com.matt_richardson.gocd.websocket_notifier.PipelineDetailsPopulator: com.google.gson.JsonElement downloadPipelineInstanceDetails(java.lang.String)>/assign/0	<com.matt_richardson.gocd.websocket_notifier.PipelineDetailsPopulator: com.google.gson.JsonElement downloadPipelineInstanceDetails(java.lang.String)>/this#_0
<com.matt_richardson.gocd.websocket_notifier.PipelineDetailsPopulator: com.google.gson.JsonElement downloadPipelineInstanceDetails(java.lang.String)>/assign/1	<com.matt_richardson.gocd.websocket_notifier.PipelineDetailsPopulator: com.google.gson.JsonElement downloadPipelineInstanceDetails(java.lang.String)>/pipelineName#_0
<com.matt_richardson.gocd.websocket_notifier.PipelineDetailsPopulator: java.lang.String extendMessageToIncludePipelineDetails(java.lang.String)>/assign/0	<com.matt_richardson.gocd.websocket_notifier.PipelineDetailsPopulator: java.lang.String extendMessageToIncludePipelineDetails(java.lang.String)>/this#_0
<com.matt_richardson.gocd.websocket_notifier.PipelineDetailsPopulator: java.lang.String extendMessageToIncludePipelineDetails(java.lang.String)>/assign/1	<com.matt_richardson.gocd.websocket_notifier.PipelineDetailsPopulator: java.lang.String extendMessageToIncludePipelineDetails(java.lang.String)>/requestBody#_0
<com.matt_richardson.gocd.websocket_notifier.PipelineDetailsPopulator: java.lang.String extendMessageToIncludePipelineDetails(java.lang.String)>/assign/5	<com.matt_richardson.gocd.websocket_notifier.PipelineDetailsPopulator: java.lang.String extendMessageToIncludePipelineDetails(java.lang.String)>/result#_58
<com.matt_richardson.gocd.websocket_notifier.PipelineDetailsPopulator: java.lang.String extendMessageToIncludePipelineDetails(java.lang.String)>/phi-assign/0	<com.matt_richardson.gocd.websocket_notifier.PipelineDetailsPopulator: java.lang.String extendMessageToIncludePipelineDetails(java.lang.String)>/pipelineName_$$A_2#_65
<com.matt_richardson.gocd.websocket_notifier.PipelineDetailsPopulator: java.lang.String extendMessageToIncludePipelineDetails(java.lang.String)>/phi-assign/1	<com.matt_richardson.gocd.websocket_notifier.PipelineDetailsPopulator: java.lang.String extendMessageToIncludePipelineDetails(java.lang.String)>/pipelineName_$$A_2#_65
<com.matt_richardson.gocd.websocket_notifier.PipelineDetailsPopulator: java.lang.String extendMessageToIncludePipelineDetails(java.lang.String)>/phi-assign/2	<com.matt_richardson.gocd.websocket_notifier.PipelineDetailsPopulator: java.lang.String extendMessageToIncludePipelineDetails(java.lang.String)>/pipelineName_$$A_3#_71
<com.matt_richardson.gocd.websocket_notifier.PipelineDetailsPopulator: java.lang.String extendMessageToIncludePipelineDetails(java.lang.String)>/phi-assign/3	<com.matt_richardson.gocd.websocket_notifier.PipelineDetailsPopulator: java.lang.String extendMessageToIncludePipelineDetails(java.lang.String)>/pipelineName_$$A_3#_71
<com.matt_richardson.gocd.websocket_notifier.PipelineDetailsPopulator: java.lang.String extendMessageToIncludePipelineDetails(java.lang.String)>/phi-assign/4	<com.matt_richardson.gocd.websocket_notifier.PipelineDetailsPopulator: java.lang.String extendMessageToIncludePipelineDetails(java.lang.String)>/pipelineName_$$A_3#_71
<com.matt_richardson.gocd.websocket_notifier.PipelineDetailsPopulator: java.lang.String extendMessageToIncludePipelineDetails(java.lang.String)>/phi-assign/5	<com.matt_richardson.gocd.websocket_notifier.PipelineDetailsPopulator: java.lang.String extendMessageToIncludePipelineDetails(java.lang.String)>/result_$$A_2#_71
<com.matt_richardson.gocd.websocket_notifier.PipelineDetailsPopulator: java.lang.String extendMessageToIncludePipelineDetails(java.lang.String)>/phi-assign/6	<com.matt_richardson.gocd.websocket_notifier.PipelineDetailsPopulator: java.lang.String extendMessageToIncludePipelineDetails(java.lang.String)>/result_$$A_2#_71
<com.matt_richardson.gocd.websocket_notifier.PipelineDetailsPopulator: java.lang.String extendMessageToIncludePipelineDetails(java.lang.String)>/phi-assign/7	<com.matt_richardson.gocd.websocket_notifier.PipelineDetailsPopulator: java.lang.String extendMessageToIncludePipelineDetails(java.lang.String)>/pipelineName_$$A_4#_70
<com.matt_richardson.gocd.websocket_notifier.PipelineDetailsPopulator: java.lang.String extendMessageToIncludePipelineDetails(java.lang.String)>/phi-assign/8	<com.matt_richardson.gocd.websocket_notifier.PipelineDetailsPopulator: java.lang.String extendMessageToIncludePipelineDetails(java.lang.String)>/pipelineName_$$A_4#_70
<com.matt_richardson.gocd.websocket_notifier.PipelineDetailsPopulator: java.lang.String extendMessageToIncludePipelineDetails(java.lang.String)>/phi-assign/9	<com.matt_richardson.gocd.websocket_notifier.PipelineDetailsPopulator: java.lang.String extendMessageToIncludePipelineDetails(java.lang.String)>/result_$$A_3#_70
<com.matt_richardson.gocd.websocket_notifier.PipelineDetailsPopulator: java.lang.String extendMessageToIncludePipelineDetails(java.lang.String)>/phi-assign/10	<com.matt_richardson.gocd.websocket_notifier.PipelineDetailsPopulator: java.lang.String extendMessageToIncludePipelineDetails(java.lang.String)>/result_$$A_3#_70
<com.matt_richardson.gocd.websocket_notifier.PipelineWebSocketServer: void sendToAll(java.lang.String)>/assign-cast/0	<com.matt_richardson.gocd.websocket_notifier.PipelineWebSocketServer: void sendToAll(java.lang.String)>/c#_44
<com.matt_richardson.gocd.websocket_notifier.GoNotificationPlugin: com.thoughtworks.go.plugin.api.response.GoPluginApiResponse handle(com.thoughtworks.go.plugin.api.request.GoPluginApiRequest)>/assign-cast/0	<com.matt_richardson.gocd.websocket_notifier.GoNotificationPlugin: com.thoughtworks.go.plugin.api.response.GoPluginApiResponse handle(com.thoughtworks.go.plugin.api.request.GoPluginApiRequest)>/$r0
<com.matt_richardson.gocd.websocket_notifier.GoNotificationPlugin: com.thoughtworks.go.plugin.api.response.GoPluginApiResponse handle(com.thoughtworks.go.plugin.api.request.GoPluginApiRequest)>/assign-cast/1	<com.matt_richardson.gocd.websocket_notifier.GoNotificationPlugin: com.thoughtworks.go.plugin.api.response.GoPluginApiResponse handle(com.thoughtworks.go.plugin.api.request.GoPluginApiRequest)>/$r1
<com.matt_richardson.gocd.websocket_notifier.PipelineDetailsPopulator: com.google.gson.JsonElement downloadPipelineInstanceDetails(java.lang.String)>/assign-cast/0	<com.matt_richardson.gocd.websocket_notifier.PipelineDetailsPopulator: com.google.gson.JsonElement downloadPipelineInstanceDetails(java.lang.String)>/request#_36
<com.matt_richardson.gocd.websocket_notifier.PipelineDetailsPopulator: com.google.gson.JsonElement downloadPipelineInstanceDetails(java.lang.String)>/assign-cast/1	<com.matt_richardson.gocd.websocket_notifier.PipelineDetailsPopulator: com.google.gson.JsonElement downloadPipelineInstanceDetails(java.lang.String)>/$stack24
<com.matt_richardson.gocd.websocket_notifier.PipelineDetailsPopulator: java.lang.String extendMessageToIncludePipelineDetails(java.lang.String)>/assign-cast/0	<com.matt_richardson.gocd.websocket_notifier.PipelineDetailsPopulator: java.lang.String extendMessageToIncludePipelineDetails(java.lang.String)>/$r0
