<com.matt_richardson.gocd.websocket_notifier.PipelineWebSocketServer: void <init>(int)>/write-field-LOGGER/0	<com.matt_richardson.gocd.websocket_notifier.PipelineWebSocketServer: com.thoughtworks.go.plugin.api.logging.Logger LOGGER>
<com.matt_richardson.gocd.websocket_notifier.PipelineWebSocketServer: void <init>(java.lang.String,int)>/write-field-LOGGER/0	<com.matt_richardson.gocd.websocket_notifier.PipelineWebSocketServer: com.thoughtworks.go.plugin.api.logging.Logger LOGGER>
<com.matt_richardson.gocd.websocket_notifier.GoNotificationPlugin$1: void <init>(com.matt_richardson.gocd.websocket_notifier.GoNotificationPlugin,int,java.lang.String)>/write-field-this$0/0	<com.matt_richardson.gocd.websocket_notifier.GoNotificationPlugin$1: com.matt_richardson.gocd.websocket_notifier.GoNotificationPlugin this$0>
<com.matt_richardson.gocd.websocket_notifier.GoNotificationPlugin$1: void <init>(com.matt_richardson.gocd.websocket_notifier.GoNotificationPlugin,int,java.lang.String)>/write-field-val$responseCode/0	<com.matt_richardson.gocd.websocket_notifier.GoNotificationPlugin$1: int val$responseCode>
<com.matt_richardson.gocd.websocket_notifier.GoNotificationPlugin$1: void <init>(com.matt_richardson.gocd.websocket_notifier.GoNotificationPlugin,int,java.lang.String)>/write-field-val$json/0	<com.matt_richardson.gocd.websocket_notifier.GoNotificationPlugin$1: java.lang.String val$json>
<com.matt_richardson.gocd.websocket_notifier.PluginConfig: void <init>()>/write-field-port/0	<com.matt_richardson.gocd.websocket_notifier.PluginConfig: int port>
<com.matt_richardson.gocd.websocket_notifier.PluginConfig: void <init>()>/write-field-host/0	<com.matt_richardson.gocd.websocket_notifier.PluginConfig: java.lang.String host>
<com.matt_richardson.gocd.websocket_notifier.PluginConfig: void <init>()>/write-field-goHttpPort/0	<com.matt_richardson.gocd.websocket_notifier.PluginConfig: int goHttpPort>
<com.matt_richardson.gocd.websocket_notifier.PluginConfig: void setPort(int)>/write-field-port/0	<com.matt_richardson.gocd.websocket_notifier.PluginConfig: int port>
<com.matt_richardson.gocd.websocket_notifier.PluginConfig: void setHost(java.lang.String)>/write-field-host/0	<com.matt_richardson.gocd.websocket_notifier.PluginConfig: java.lang.String host>
<com.matt_richardson.gocd.websocket_notifier.PluginConfig: void setGoHttpPort(int)>/write-field-goHttpPort/0	<com.matt_richardson.gocd.websocket_notifier.PluginConfig: int goHttpPort>
<com.matt_richardson.gocd.websocket_notifier.PluginConfig: void setGoUser(java.lang.String)>/write-field-goUser/0	<com.matt_richardson.gocd.websocket_notifier.PluginConfig: java.lang.String goUser>
<com.matt_richardson.gocd.websocket_notifier.PluginConfig: void setGoPassword(java.lang.String)>/write-field-goPassword/0	<com.matt_richardson.gocd.websocket_notifier.PluginConfig: java.lang.String goPassword>
<com.matt_richardson.gocd.websocket_notifier.WebSocketPipelineListener: void <init>(com.matt_richardson.gocd.websocket_notifier.PipelineWebSocketServer,com.matt_richardson.gocd.websocket_notifier.PluginConfig)>/write-field-LOGGER/0	<com.matt_richardson.gocd.websocket_notifier.WebSocketPipelineListener: com.thoughtworks.go.plugin.api.logging.Logger LOGGER>
<com.matt_richardson.gocd.websocket_notifier.WebSocketPipelineListener: void <init>(com.matt_richardson.gocd.websocket_notifier.PipelineWebSocketServer,com.matt_richardson.gocd.websocket_notifier.PluginConfig)>/write-field-webSocketServer/0	<com.matt_richardson.gocd.websocket_notifier.WebSocketPipelineListener: com.matt_richardson.gocd.websocket_notifier.PipelineWebSocketServer webSocketServer>
<com.matt_richardson.gocd.websocket_notifier.WebSocketPipelineListener: void <init>(com.matt_richardson.gocd.websocket_notifier.PipelineWebSocketServer,com.matt_richardson.gocd.websocket_notifier.PluginConfig)>/write-field-populator/0	<com.matt_richardson.gocd.websocket_notifier.WebSocketPipelineListener: com.matt_richardson.gocd.websocket_notifier.PipelineDetailsPopulator populator>
<com.matt_richardson.gocd.websocket_notifier.PipelineDetailsPopulator: void <init>(com.matt_richardson.gocd.websocket_notifier.PluginConfig)>/write-field-pluginConfig/0	<com.matt_richardson.gocd.websocket_notifier.PipelineDetailsPopulator: com.matt_richardson.gocd.websocket_notifier.PluginConfig pluginConfig>
<com.matt_richardson.gocd.websocket_notifier.PipelineWebSocketServer: void onOpen(org.java_websocket.WebSocket,org.java_websocket.handshake.ClientHandshake)>/read-field-LOGGER/0	<com.matt_richardson.gocd.websocket_notifier.PipelineWebSocketServer: com.thoughtworks.go.plugin.api.logging.Logger LOGGER>
<com.matt_richardson.gocd.websocket_notifier.PipelineWebSocketServer: void onClose(org.java_websocket.WebSocket,int,java.lang.String,boolean)>/read-field-LOGGER/0	<com.matt_richardson.gocd.websocket_notifier.PipelineWebSocketServer: com.thoughtworks.go.plugin.api.logging.Logger LOGGER>
<com.matt_richardson.gocd.websocket_notifier.PipelineWebSocketServer: void onError(org.java_websocket.WebSocket,java.lang.Exception)>/read-field-LOGGER/0	<com.matt_richardson.gocd.websocket_notifier.PipelineWebSocketServer: com.thoughtworks.go.plugin.api.logging.Logger LOGGER>
<com.matt_richardson.gocd.websocket_notifier.PipelineWebSocketServer: void sendToAll(java.lang.String)>/read-field-LOGGER/0	<com.matt_richardson.gocd.websocket_notifier.PipelineWebSocketServer: com.thoughtworks.go.plugin.api.logging.Logger LOGGER>
<com.matt_richardson.gocd.websocket_notifier.GoNotificationPlugin$1: int responseCode()>/read-field-val$responseCode/0	<com.matt_richardson.gocd.websocket_notifier.GoNotificationPlugin$1: int val$responseCode>
<com.matt_richardson.gocd.websocket_notifier.GoNotificationPlugin$1: java.lang.String responseBody()>/read-field-val$json/0	<com.matt_richardson.gocd.websocket_notifier.GoNotificationPlugin$1: java.lang.String val$json>
<com.matt_richardson.gocd.websocket_notifier.PluginConfig: int getPort()>/read-field-port/0	<com.matt_richardson.gocd.websocket_notifier.PluginConfig: int port>
<com.matt_richardson.gocd.websocket_notifier.PluginConfig: java.lang.String getHost()>/read-field-host/0	<com.matt_richardson.gocd.websocket_notifier.PluginConfig: java.lang.String host>
<com.matt_richardson.gocd.websocket_notifier.PluginConfig: boolean isHostSet()>/read-field-host/0	<com.matt_richardson.gocd.websocket_notifier.PluginConfig: java.lang.String host>
<com.matt_richardson.gocd.websocket_notifier.PluginConfig: int getGoHttpPort()>/read-field-goHttpPort/0	<com.matt_richardson.gocd.websocket_notifier.PluginConfig: int goHttpPort>
<com.matt_richardson.gocd.websocket_notifier.PluginConfig: java.lang.String getGoUser()>/read-field-goUser/0	<com.matt_richardson.gocd.websocket_notifier.PluginConfig: java.lang.String goUser>
<com.matt_richardson.gocd.websocket_notifier.PluginConfig: boolean isGoUserSet()>/read-field-goUser/0	<com.matt_richardson.gocd.websocket_notifier.PluginConfig: java.lang.String goUser>
<com.matt_richardson.gocd.websocket_notifier.PluginConfig: java.lang.String getGoPassword()>/read-field-goPassword/0	<com.matt_richardson.gocd.websocket_notifier.PluginConfig: java.lang.String goPassword>
<com.matt_richardson.gocd.websocket_notifier.PluginConfig: boolean isGoPasswordSet()>/read-field-goPassword/0	<com.matt_richardson.gocd.websocket_notifier.PluginConfig: java.lang.String goPassword>
<com.matt_richardson.gocd.websocket_notifier.WebSocketPipelineListener: void notify(com.thoughtworks.go.plugin.api.request.GoPluginApiRequest)>/read-field-LOGGER/0	<com.matt_richardson.gocd.websocket_notifier.WebSocketPipelineListener: com.thoughtworks.go.plugin.api.logging.Logger LOGGER>
<com.matt_richardson.gocd.websocket_notifier.WebSocketPipelineListener: void notify(com.thoughtworks.go.plugin.api.request.GoPluginApiRequest)>/read-field-populator/0	<com.matt_richardson.gocd.websocket_notifier.WebSocketPipelineListener: com.matt_richardson.gocd.websocket_notifier.PipelineDetailsPopulator populator>
<com.matt_richardson.gocd.websocket_notifier.WebSocketPipelineListener: void notify(com.thoughtworks.go.plugin.api.request.GoPluginApiRequest)>/read-field-webSocketServer/0	<com.matt_richardson.gocd.websocket_notifier.WebSocketPipelineListener: com.matt_richardson.gocd.websocket_notifier.PipelineWebSocketServer webSocketServer>
<com.matt_richardson.gocd.websocket_notifier.PipelineDetailsPopulator: com.google.gson.JsonElement downloadPipelineInstanceDetails(java.lang.String)>/read-field-pluginConfig/0	<com.matt_richardson.gocd.websocket_notifier.PipelineDetailsPopulator: com.matt_richardson.gocd.websocket_notifier.PluginConfig pluginConfig>
<com.matt_richardson.gocd.websocket_notifier.PipelineDetailsPopulator: com.google.gson.JsonElement downloadPipelineInstanceDetails(java.lang.String)>/read-field-pluginConfig/1	<com.matt_richardson.gocd.websocket_notifier.PipelineDetailsPopulator: com.matt_richardson.gocd.websocket_notifier.PluginConfig pluginConfig>
<com.matt_richardson.gocd.websocket_notifier.PipelineDetailsPopulator: com.google.gson.JsonElement downloadPipelineInstanceDetails(java.lang.String)>/read-field-pluginConfig/2	<com.matt_richardson.gocd.websocket_notifier.PipelineDetailsPopulator: com.matt_richardson.gocd.websocket_notifier.PluginConfig pluginConfig>
<com.matt_richardson.gocd.websocket_notifier.PipelineDetailsPopulator: com.google.gson.JsonElement downloadPipelineInstanceDetails(java.lang.String)>/read-field-pluginConfig/3	<com.matt_richardson.gocd.websocket_notifier.PipelineDetailsPopulator: com.matt_richardson.gocd.websocket_notifier.PluginConfig pluginConfig>
<com.matt_richardson.gocd.websocket_notifier.GoNotificationPlugin: void initializeGoApplicationAccessor(com.thoughtworks.go.plugin.api.GoApplicationAccessor)>/write-field-pipelineListener/0	<com.matt_richardson.gocd.websocket_notifier.GoNotificationPlugin: com.matt_richardson.gocd.websocket_notifier.WebSocketPipelineListener pipelineListener>
<com.matt_richardson.gocd.websocket_notifier.GoNotificationPlugin: void <init>(com.matt_richardson.gocd.websocket_notifier.WebSocketPipelineListener)>/write-field-pipelineListener/0	<com.matt_richardson.gocd.websocket_notifier.GoNotificationPlugin: com.matt_richardson.gocd.websocket_notifier.WebSocketPipelineListener pipelineListener>
<com.matt_richardson.gocd.websocket_notifier.GoNotificationPlugin: void <clinit>()>/write-field-LOGGER/0	<com.matt_richardson.gocd.websocket_notifier.GoNotificationPlugin: com.thoughtworks.go.plugin.api.logging.Logger LOGGER>
<com.matt_richardson.gocd.websocket_notifier.GoNotificationPlugin: void <clinit>()>/write-field-goSupportedVersions/0	<com.matt_richardson.gocd.websocket_notifier.GoNotificationPlugin: java.util.List goSupportedVersions>
<com.matt_richardson.gocd.websocket_notifier.PluginConfig: void <clinit>()>/write-field-LOGGER/0	<com.matt_richardson.gocd.websocket_notifier.PluginConfig: com.thoughtworks.go.plugin.api.logging.Logger LOGGER>
<com.matt_richardson.gocd.websocket_notifier.PipelineDetailsPopulator: void <clinit>()>/write-field-LOGGER/0	<com.matt_richardson.gocd.websocket_notifier.PipelineDetailsPopulator: com.thoughtworks.go.plugin.api.logging.Logger LOGGER>
<com.matt_richardson.gocd.websocket_notifier.GoNotificationPlugin: void initializeGoApplicationAccessor(com.thoughtworks.go.plugin.api.GoApplicationAccessor)>/read-field-pipelineListener/0	<com.matt_richardson.gocd.websocket_notifier.GoNotificationPlugin: com.matt_richardson.gocd.websocket_notifier.WebSocketPipelineListener pipelineListener>
<com.matt_richardson.gocd.websocket_notifier.GoNotificationPlugin: void initializeGoApplicationAccessor(com.thoughtworks.go.plugin.api.GoApplicationAccessor)>/read-field-LOGGER/0	<com.matt_richardson.gocd.websocket_notifier.GoNotificationPlugin: com.thoughtworks.go.plugin.api.logging.Logger LOGGER>
<com.matt_richardson.gocd.websocket_notifier.GoNotificationPlugin: void initializeGoApplicationAccessor(com.thoughtworks.go.plugin.api.GoApplicationAccessor)>/read-field-LOGGER/1	<com.matt_richardson.gocd.websocket_notifier.GoNotificationPlugin: com.thoughtworks.go.plugin.api.logging.Logger LOGGER>
<com.matt_richardson.gocd.websocket_notifier.GoNotificationPlugin: void initializeGoApplicationAccessor(com.thoughtworks.go.plugin.api.GoApplicationAccessor)>/read-field-LOGGER/2	<com.matt_richardson.gocd.websocket_notifier.GoNotificationPlugin: com.thoughtworks.go.plugin.api.logging.Logger LOGGER>
<com.matt_richardson.gocd.websocket_notifier.GoNotificationPlugin: com.thoughtworks.go.plugin.api.response.GoPluginApiResponse handle(com.thoughtworks.go.plugin.api.request.GoPluginApiRequest)>/read-field-LOGGER/0	<com.matt_richardson.gocd.websocket_notifier.GoNotificationPlugin: com.thoughtworks.go.plugin.api.logging.Logger LOGGER>
<com.matt_richardson.gocd.websocket_notifier.GoNotificationPlugin: com.thoughtworks.go.plugin.api.response.GoPluginApiResponse handle(com.thoughtworks.go.plugin.api.request.GoPluginApiRequest)>/read-field-LOGGER/1	<com.matt_richardson.gocd.websocket_notifier.GoNotificationPlugin: com.thoughtworks.go.plugin.api.logging.Logger LOGGER>
<com.matt_richardson.gocd.websocket_notifier.GoNotificationPlugin: com.thoughtworks.go.plugin.api.GoPluginIdentifier pluginIdentifier()>/read-field-LOGGER/0	<com.matt_richardson.gocd.websocket_notifier.GoNotificationPlugin: com.thoughtworks.go.plugin.api.logging.Logger LOGGER>
<com.matt_richardson.gocd.websocket_notifier.GoNotificationPlugin: com.thoughtworks.go.plugin.api.GoPluginIdentifier pluginIdentifier()>/read-field-goSupportedVersions/0	<com.matt_richardson.gocd.websocket_notifier.GoNotificationPlugin: java.util.List goSupportedVersions>
<com.matt_richardson.gocd.websocket_notifier.GoNotificationPlugin: com.thoughtworks.go.plugin.api.response.GoPluginApiResponse handleNotificationsInterestedIn()>/read-field-LOGGER/0	<com.matt_richardson.gocd.websocket_notifier.GoNotificationPlugin: com.thoughtworks.go.plugin.api.logging.Logger LOGGER>
<com.matt_richardson.gocd.websocket_notifier.GoNotificationPlugin: com.thoughtworks.go.plugin.api.response.GoPluginApiResponse handleStageNotification(com.thoughtworks.go.plugin.api.request.GoPluginApiRequest)>/read-field-LOGGER/0	<com.matt_richardson.gocd.websocket_notifier.GoNotificationPlugin: com.thoughtworks.go.plugin.api.logging.Logger LOGGER>
<com.matt_richardson.gocd.websocket_notifier.GoNotificationPlugin: com.thoughtworks.go.plugin.api.response.GoPluginApiResponse handleStageNotification(com.thoughtworks.go.plugin.api.request.GoPluginApiRequest)>/read-field-pipelineListener/0	<com.matt_richardson.gocd.websocket_notifier.GoNotificationPlugin: com.matt_richardson.gocd.websocket_notifier.WebSocketPipelineListener pipelineListener>
<com.matt_richardson.gocd.websocket_notifier.GoNotificationPlugin: com.thoughtworks.go.plugin.api.response.GoPluginApiResponse handleStageNotification(com.thoughtworks.go.plugin.api.request.GoPluginApiRequest)>/read-field-LOGGER/1	<com.matt_richardson.gocd.websocket_notifier.GoNotificationPlugin: com.thoughtworks.go.plugin.api.logging.Logger LOGGER>
<com.matt_richardson.gocd.websocket_notifier.PluginConfig: void <init>()>/read-field-separator/0	<java.io.File: java.lang.String separator>
<com.matt_richardson.gocd.websocket_notifier.PluginConfig: void <init>()>/read-field-LOGGER/0	<com.matt_richardson.gocd.websocket_notifier.PluginConfig: com.thoughtworks.go.plugin.api.logging.Logger LOGGER>
<com.matt_richardson.gocd.websocket_notifier.PipelineDetailsPopulator: java.lang.String extendMessageToIncludePipelineDetails(java.lang.String)>/read-field-LOGGER/0	<com.matt_richardson.gocd.websocket_notifier.PipelineDetailsPopulator: com.thoughtworks.go.plugin.api.logging.Logger LOGGER>
