<com.matt_richardson.gocd.websocket_notifier.PipelineWebSocketServer: void onOpen(org.java_websocket.WebSocket,org.java_websocket.handshake.ClientHandshake)>/org.java_websocket.WebSocket.getRemoteSocketAddress/0	<org.java_websocket.WebSocket: java.net.InetSocketAddress getRemoteSocketAddress()>
<com.matt_richardson.gocd.websocket_notifier.PipelineWebSocketServer: void onOpen(org.java_websocket.WebSocket,org.java_websocket.handshake.ClientHandshake)>/java.net.InetSocketAddress.getAddress/0	<java.net.InetSocketAddress: java.net.InetAddress getAddress()>
<com.matt_richardson.gocd.websocket_notifier.PipelineWebSocketServer: void onOpen(org.java_websocket.WebSocket,org.java_websocket.handshake.ClientHandshake)>/java.net.InetAddress.getHostAddress/0	<java.net.InetAddress: java.lang.String getHostAddress()>
<com.matt_richardson.gocd.websocket_notifier.PipelineWebSocketServer: void onOpen(org.java_websocket.WebSocket,org.java_websocket.handshake.ClientHandshake)>/java.lang.StringBuilder.append/0	<java.lang.StringBuilder: java.lang.StringBuilder append(java.lang.String)>
<com.matt_richardson.gocd.websocket_notifier.PipelineWebSocketServer: void onOpen(org.java_websocket.WebSocket,org.java_websocket.handshake.ClientHandshake)>/java.lang.StringBuilder.append/1	<java.lang.StringBuilder: java.lang.StringBuilder append(java.lang.String)>
<com.matt_richardson.gocd.websocket_notifier.PipelineWebSocketServer: void onOpen(org.java_websocket.WebSocket,org.java_websocket.handshake.ClientHandshake)>/java.lang.StringBuilder.toString/0	<java.lang.StringBuilder: java.lang.String toString()>
<com.matt_richardson.gocd.websocket_notifier.PipelineWebSocketServer: void onOpen(org.java_websocket.WebSocket,org.java_websocket.handshake.ClientHandshake)>/com.thoughtworks.go.plugin.api.logging.Logger.debug/0	<com.thoughtworks.go.plugin.api.logging.Logger: void debug(java.lang.String)>
<com.matt_richardson.gocd.websocket_notifier.PipelineWebSocketServer: void onClose(org.java_websocket.WebSocket,int,java.lang.String,boolean)>/java.lang.StringBuilder.append/0	<java.lang.StringBuilder: java.lang.StringBuilder append(java.lang.Object)>
<com.matt_richardson.gocd.websocket_notifier.PipelineWebSocketServer: void onClose(org.java_websocket.WebSocket,int,java.lang.String,boolean)>/java.lang.StringBuilder.append/1	<java.lang.StringBuilder: java.lang.StringBuilder append(java.lang.String)>
<com.matt_richardson.gocd.websocket_notifier.PipelineWebSocketServer: void onClose(org.java_websocket.WebSocket,int,java.lang.String,boolean)>/java.lang.StringBuilder.toString/0	<java.lang.StringBuilder: java.lang.String toString()>
<com.matt_richardson.gocd.websocket_notifier.PipelineWebSocketServer: void onClose(org.java_websocket.WebSocket,int,java.lang.String,boolean)>/com.thoughtworks.go.plugin.api.logging.Logger.debug/0	<com.thoughtworks.go.plugin.api.logging.Logger: void debug(java.lang.String)>
<com.matt_richardson.gocd.websocket_notifier.PipelineWebSocketServer: void onError(org.java_websocket.WebSocket,java.lang.Exception)>/com.thoughtworks.go.plugin.api.logging.Logger.warn/0	<com.thoughtworks.go.plugin.api.logging.Logger: void warn(java.lang.String,java.lang.Throwable)>
<com.matt_richardson.gocd.websocket_notifier.PipelineWebSocketServer: void sendToAll(java.lang.String)>/com.matt_richardson.gocd.websocket_notifier.PipelineWebSocketServer.connections/0	<org.java_websocket.server.WebSocketServer: java.util.Collection connections()>
<com.matt_richardson.gocd.websocket_notifier.PipelineWebSocketServer: void sendToAll(java.lang.String)>/java.util.Collection.iterator/0	<java.util.Collection: java.util.Iterator iterator()>
<com.matt_richardson.gocd.websocket_notifier.PipelineWebSocketServer: void sendToAll(java.lang.String)>/java.util.Iterator.hasNext/0	<java.util.Iterator: boolean hasNext()>
<com.matt_richardson.gocd.websocket_notifier.PipelineWebSocketServer: void sendToAll(java.lang.String)>/java.util.Iterator.next/0	<java.util.Iterator: java.lang.Object next()>
<com.matt_richardson.gocd.websocket_notifier.PipelineWebSocketServer: void sendToAll(java.lang.String)>/java.lang.StringBuilder.append/0	<java.lang.StringBuilder: java.lang.StringBuilder append(java.lang.String)>
<com.matt_richardson.gocd.websocket_notifier.PipelineWebSocketServer: void sendToAll(java.lang.String)>/java.lang.StringBuilder.append/1	<java.lang.StringBuilder: java.lang.StringBuilder append(java.lang.String)>
<com.matt_richardson.gocd.websocket_notifier.PipelineWebSocketServer: void sendToAll(java.lang.String)>/java.lang.StringBuilder.append/2	<java.lang.StringBuilder: java.lang.StringBuilder append(java.lang.String)>
<com.matt_richardson.gocd.websocket_notifier.PipelineWebSocketServer: void sendToAll(java.lang.String)>/java.lang.StringBuilder.append/3	<java.lang.StringBuilder: java.lang.StringBuilder append(java.lang.Object)>
<com.matt_richardson.gocd.websocket_notifier.PipelineWebSocketServer: void sendToAll(java.lang.String)>/java.lang.StringBuilder.toString/0	<java.lang.StringBuilder: java.lang.String toString()>
<com.matt_richardson.gocd.websocket_notifier.PipelineWebSocketServer: void sendToAll(java.lang.String)>/com.thoughtworks.go.plugin.api.logging.Logger.debug/0	<com.thoughtworks.go.plugin.api.logging.Logger: void debug(java.lang.String)>
<com.matt_richardson.gocd.websocket_notifier.PipelineWebSocketServer: void sendToAll(java.lang.String)>/org.java_websocket.WebSocket.send/0	<org.java_websocket.WebSocket: void send(java.lang.String)>
<com.matt_richardson.gocd.websocket_notifier.GoNotificationPlugin: void initializeGoApplicationAccessor(com.thoughtworks.go.plugin.api.GoApplicationAccessor)>/com.matt_richardson.gocd.websocket_notifier.PluginConfig.getPort/0	<com.matt_richardson.gocd.websocket_notifier.PluginConfig: int getPort()>
<com.matt_richardson.gocd.websocket_notifier.GoNotificationPlugin: void initializeGoApplicationAccessor(com.thoughtworks.go.plugin.api.GoApplicationAccessor)>/com.matt_richardson.gocd.websocket_notifier.PluginConfig.getHost/0	<com.matt_richardson.gocd.websocket_notifier.PluginConfig: java.lang.String getHost()>
<com.matt_richardson.gocd.websocket_notifier.GoNotificationPlugin: void initializeGoApplicationAccessor(com.thoughtworks.go.plugin.api.GoApplicationAccessor)>/java.lang.StringBuilder.append/0	<java.lang.StringBuilder: java.lang.StringBuilder append(java.lang.String)>
<com.matt_richardson.gocd.websocket_notifier.GoNotificationPlugin: void initializeGoApplicationAccessor(com.thoughtworks.go.plugin.api.GoApplicationAccessor)>/java.lang.StringBuilder.append/1	<java.lang.StringBuilder: java.lang.StringBuilder append(int)>
<com.matt_richardson.gocd.websocket_notifier.GoNotificationPlugin: void initializeGoApplicationAccessor(com.thoughtworks.go.plugin.api.GoApplicationAccessor)>/java.lang.StringBuilder.toString/0	<java.lang.StringBuilder: java.lang.String toString()>
<com.matt_richardson.gocd.websocket_notifier.GoNotificationPlugin: void initializeGoApplicationAccessor(com.thoughtworks.go.plugin.api.GoApplicationAccessor)>/com.thoughtworks.go.plugin.api.logging.Logger.info/0	<com.thoughtworks.go.plugin.api.logging.Logger: void info(java.lang.String)>
<com.matt_richardson.gocd.websocket_notifier.GoNotificationPlugin: void initializeGoApplicationAccessor(com.thoughtworks.go.plugin.api.GoApplicationAccessor)>/com.matt_richardson.gocd.websocket_notifier.PluginConfig.isHostSet/0	<com.matt_richardson.gocd.websocket_notifier.PluginConfig: boolean isHostSet()>
<com.matt_richardson.gocd.websocket_notifier.GoNotificationPlugin: void initializeGoApplicationAccessor(com.thoughtworks.go.plugin.api.GoApplicationAccessor)>/com.matt_richardson.gocd.websocket_notifier.PipelineWebSocketServer.start/0	<org.java_websocket.server.WebSocketServer: void start()>
<com.matt_richardson.gocd.websocket_notifier.GoNotificationPlugin: void initializeGoApplicationAccessor(com.thoughtworks.go.plugin.api.GoApplicationAccessor)>/java.lang.StringBuilder.append/2	<java.lang.StringBuilder: java.lang.StringBuilder append(java.lang.String)>
<com.matt_richardson.gocd.websocket_notifier.GoNotificationPlugin: void initializeGoApplicationAccessor(com.thoughtworks.go.plugin.api.GoApplicationAccessor)>/com.matt_richardson.gocd.websocket_notifier.PipelineWebSocketServer.getPort/0	<org.java_websocket.server.WebSocketServer: int getPort()>
<com.matt_richardson.gocd.websocket_notifier.GoNotificationPlugin: void initializeGoApplicationAccessor(com.thoughtworks.go.plugin.api.GoApplicationAccessor)>/java.lang.StringBuilder.append/3	<java.lang.StringBuilder: java.lang.StringBuilder append(int)>
<com.matt_richardson.gocd.websocket_notifier.GoNotificationPlugin: void initializeGoApplicationAccessor(com.thoughtworks.go.plugin.api.GoApplicationAccessor)>/java.lang.StringBuilder.toString/1	<java.lang.StringBuilder: java.lang.String toString()>
<com.matt_richardson.gocd.websocket_notifier.GoNotificationPlugin: void initializeGoApplicationAccessor(com.thoughtworks.go.plugin.api.GoApplicationAccessor)>/com.thoughtworks.go.plugin.api.logging.Logger.info/1	<com.thoughtworks.go.plugin.api.logging.Logger: void info(java.lang.String)>
<com.matt_richardson.gocd.websocket_notifier.GoNotificationPlugin: void initializeGoApplicationAccessor(com.thoughtworks.go.plugin.api.GoApplicationAccessor)>/java.lang.StringBuilder.append/4	<java.lang.StringBuilder: java.lang.StringBuilder append(java.lang.String)>
<com.matt_richardson.gocd.websocket_notifier.GoNotificationPlugin: void initializeGoApplicationAccessor(com.thoughtworks.go.plugin.api.GoApplicationAccessor)>/java.lang.StringBuilder.append/5	<java.lang.StringBuilder: java.lang.StringBuilder append(int)>
<com.matt_richardson.gocd.websocket_notifier.GoNotificationPlugin: void initializeGoApplicationAccessor(com.thoughtworks.go.plugin.api.GoApplicationAccessor)>/java.lang.StringBuilder.toString/2	<java.lang.StringBuilder: java.lang.String toString()>
<com.matt_richardson.gocd.websocket_notifier.GoNotificationPlugin: void initializeGoApplicationAccessor(com.thoughtworks.go.plugin.api.GoApplicationAccessor)>/com.thoughtworks.go.plugin.api.logging.Logger.error/0	<com.thoughtworks.go.plugin.api.logging.Logger: void error(java.lang.String,java.lang.Throwable)>
<com.matt_richardson.gocd.websocket_notifier.GoNotificationPlugin: com.thoughtworks.go.plugin.api.response.GoPluginApiResponse handle(com.thoughtworks.go.plugin.api.request.GoPluginApiRequest)>/java.lang.StringBuilder.append/0	<java.lang.StringBuilder: java.lang.StringBuilder append(java.lang.String)>
<com.matt_richardson.gocd.websocket_notifier.GoNotificationPlugin: com.thoughtworks.go.plugin.api.response.GoPluginApiResponse handle(com.thoughtworks.go.plugin.api.request.GoPluginApiRequest)>/com.thoughtworks.go.plugin.api.request.GoPluginApiRequest.requestName/0	<com.thoughtworks.go.plugin.api.request.GoPluginApiRequest: java.lang.String requestName()>
<com.matt_richardson.gocd.websocket_notifier.GoNotificationPlugin: com.thoughtworks.go.plugin.api.response.GoPluginApiResponse handle(com.thoughtworks.go.plugin.api.request.GoPluginApiRequest)>/java.lang.StringBuilder.append/1	<java.lang.StringBuilder: java.lang.StringBuilder append(java.lang.String)>
<com.matt_richardson.gocd.websocket_notifier.GoNotificationPlugin: com.thoughtworks.go.plugin.api.response.GoPluginApiResponse handle(com.thoughtworks.go.plugin.api.request.GoPluginApiRequest)>/java.lang.StringBuilder.toString/0	<java.lang.StringBuilder: java.lang.String toString()>
<com.matt_richardson.gocd.websocket_notifier.GoNotificationPlugin: com.thoughtworks.go.plugin.api.response.GoPluginApiResponse handle(com.thoughtworks.go.plugin.api.request.GoPluginApiRequest)>/com.thoughtworks.go.plugin.api.logging.Logger.debug/0	<com.thoughtworks.go.plugin.api.logging.Logger: void debug(java.lang.String)>
<com.matt_richardson.gocd.websocket_notifier.GoNotificationPlugin: com.thoughtworks.go.plugin.api.response.GoPluginApiResponse handle(com.thoughtworks.go.plugin.api.request.GoPluginApiRequest)>/com.thoughtworks.go.plugin.api.request.GoPluginApiRequest.requestName/1	<com.thoughtworks.go.plugin.api.request.GoPluginApiRequest: java.lang.String requestName()>
<com.matt_richardson.gocd.websocket_notifier.GoNotificationPlugin: com.thoughtworks.go.plugin.api.response.GoPluginApiResponse handle(com.thoughtworks.go.plugin.api.request.GoPluginApiRequest)>/java.lang.String.equals/0	<java.lang.String: boolean equals(java.lang.Object)>
<com.matt_richardson.gocd.websocket_notifier.GoNotificationPlugin: com.thoughtworks.go.plugin.api.response.GoPluginApiResponse handle(com.thoughtworks.go.plugin.api.request.GoPluginApiRequest)>/com.thoughtworks.go.plugin.api.request.GoPluginApiRequest.requestName/2	<com.thoughtworks.go.plugin.api.request.GoPluginApiRequest: java.lang.String requestName()>
<com.matt_richardson.gocd.websocket_notifier.GoNotificationPlugin: com.thoughtworks.go.plugin.api.response.GoPluginApiResponse handle(com.thoughtworks.go.plugin.api.request.GoPluginApiRequest)>/java.lang.String.equals/1	<java.lang.String: boolean equals(java.lang.Object)>
<com.matt_richardson.gocd.websocket_notifier.GoNotificationPlugin: com.thoughtworks.go.plugin.api.response.GoPluginApiResponse handle(com.thoughtworks.go.plugin.api.request.GoPluginApiRequest)>/java.lang.StringBuilder.append/2	<java.lang.StringBuilder: java.lang.StringBuilder append(java.lang.String)>
<com.matt_richardson.gocd.websocket_notifier.GoNotificationPlugin: com.thoughtworks.go.plugin.api.response.GoPluginApiResponse handle(com.thoughtworks.go.plugin.api.request.GoPluginApiRequest)>/com.thoughtworks.go.plugin.api.request.GoPluginApiRequest.requestName/3	<com.thoughtworks.go.plugin.api.request.GoPluginApiRequest: java.lang.String requestName()>
<com.matt_richardson.gocd.websocket_notifier.GoNotificationPlugin: com.thoughtworks.go.plugin.api.response.GoPluginApiResponse handle(com.thoughtworks.go.plugin.api.request.GoPluginApiRequest)>/java.lang.StringBuilder.append/3	<java.lang.StringBuilder: java.lang.StringBuilder append(java.lang.String)>
<com.matt_richardson.gocd.websocket_notifier.GoNotificationPlugin: com.thoughtworks.go.plugin.api.response.GoPluginApiResponse handle(com.thoughtworks.go.plugin.api.request.GoPluginApiRequest)>/java.lang.StringBuilder.toString/1	<java.lang.StringBuilder: java.lang.String toString()>
<com.matt_richardson.gocd.websocket_notifier.GoNotificationPlugin: com.thoughtworks.go.plugin.api.response.GoPluginApiResponse handle(com.thoughtworks.go.plugin.api.request.GoPluginApiRequest)>/com.thoughtworks.go.plugin.api.request.GoPluginApiRequest.requestName/4	<com.thoughtworks.go.plugin.api.request.GoPluginApiRequest: java.lang.String requestName()>
<com.matt_richardson.gocd.websocket_notifier.GoNotificationPlugin: com.thoughtworks.go.plugin.api.response.GoPluginApiResponse handle(com.thoughtworks.go.plugin.api.request.GoPluginApiRequest)>/com.thoughtworks.go.plugin.api.request.GoPluginApiRequest.requestBody/0	<com.thoughtworks.go.plugin.api.request.GoPluginApiRequest: java.lang.String requestBody()>
<com.matt_richardson.gocd.websocket_notifier.GoNotificationPlugin: com.thoughtworks.go.plugin.api.response.GoPluginApiResponse handle(com.thoughtworks.go.plugin.api.request.GoPluginApiRequest)>/com.thoughtworks.go.plugin.api.logging.Logger.error/0	<com.thoughtworks.go.plugin.api.logging.Logger: void error(java.lang.String,java.lang.Throwable)>
<com.matt_richardson.gocd.websocket_notifier.GoNotificationPlugin: com.thoughtworks.go.plugin.api.response.GoPluginApiResponse handle(com.thoughtworks.go.plugin.api.request.GoPluginApiRequest)>/java.lang.Exception.getMessage/0	<java.lang.Throwable: java.lang.String getMessage()>
<com.matt_richardson.gocd.websocket_notifier.GoNotificationPlugin: com.thoughtworks.go.plugin.api.GoPluginIdentifier pluginIdentifier()>/com.thoughtworks.go.plugin.api.logging.Logger.debug/0	<com.thoughtworks.go.plugin.api.logging.Logger: void debug(java.lang.String)>
<com.matt_richardson.gocd.websocket_notifier.GoNotificationPlugin: com.thoughtworks.go.plugin.api.response.GoPluginApiResponse handleNotificationsInterestedIn()>/java.util.Map.put/0	<java.util.Map: java.lang.Object put(java.lang.Object,java.lang.Object)>
<com.matt_richardson.gocd.websocket_notifier.GoNotificationPlugin: com.thoughtworks.go.plugin.api.response.GoPluginApiResponse handleNotificationsInterestedIn()>/com.thoughtworks.go.plugin.api.logging.Logger.debug/0	<com.thoughtworks.go.plugin.api.logging.Logger: void debug(java.lang.String)>
<com.matt_richardson.gocd.websocket_notifier.GoNotificationPlugin: com.thoughtworks.go.plugin.api.response.GoPluginApiResponse handleStageNotification(com.thoughtworks.go.plugin.api.request.GoPluginApiRequest)>/com.thoughtworks.go.plugin.api.logging.Logger.debug/0	<com.thoughtworks.go.plugin.api.logging.Logger: void debug(java.lang.String)>
<com.matt_richardson.gocd.websocket_notifier.GoNotificationPlugin: com.thoughtworks.go.plugin.api.response.GoPluginApiResponse handleStageNotification(com.thoughtworks.go.plugin.api.request.GoPluginApiRequest)>/java.util.Map.put/0	<java.util.Map: java.lang.Object put(java.lang.Object,java.lang.Object)>
<com.matt_richardson.gocd.websocket_notifier.GoNotificationPlugin: com.thoughtworks.go.plugin.api.response.GoPluginApiResponse handleStageNotification(com.thoughtworks.go.plugin.api.request.GoPluginApiRequest)>/com.matt_richardson.gocd.websocket_notifier.WebSocketPipelineListener.notify/0	<com.matt_richardson.gocd.websocket_notifier.WebSocketPipelineListener: void notify(com.thoughtworks.go.plugin.api.request.GoPluginApiRequest)>
<com.matt_richardson.gocd.websocket_notifier.GoNotificationPlugin: com.thoughtworks.go.plugin.api.response.GoPluginApiResponse handleStageNotification(com.thoughtworks.go.plugin.api.request.GoPluginApiRequest)>/com.thoughtworks.go.plugin.api.logging.Logger.error/0	<com.thoughtworks.go.plugin.api.logging.Logger: void error(java.lang.String,java.lang.Throwable)>
<com.matt_richardson.gocd.websocket_notifier.GoNotificationPlugin: com.thoughtworks.go.plugin.api.response.GoPluginApiResponse handleStageNotification(com.thoughtworks.go.plugin.api.request.GoPluginApiRequest)>/java.util.Map.put/1	<java.util.Map: java.lang.Object put(java.lang.Object,java.lang.Object)>
<com.matt_richardson.gocd.websocket_notifier.GoNotificationPlugin: com.thoughtworks.go.plugin.api.response.GoPluginApiResponse handleStageNotification(com.thoughtworks.go.plugin.api.request.GoPluginApiRequest)>/java.lang.Exception.getMessage/0	<java.lang.Throwable: java.lang.String getMessage()>
<com.matt_richardson.gocd.websocket_notifier.GoNotificationPlugin: com.thoughtworks.go.plugin.api.response.GoPluginApiResponse handleStageNotification(com.thoughtworks.go.plugin.api.request.GoPluginApiRequest)>/java.util.List.add/0	<java.util.List: boolean add(java.lang.Object)>
<com.matt_richardson.gocd.websocket_notifier.GoNotificationPlugin: com.thoughtworks.go.plugin.api.response.GoPluginApiResponse handleStageNotification(com.thoughtworks.go.plugin.api.request.GoPluginApiRequest)>/java.util.Map.put/2	<java.util.Map: java.lang.Object put(java.lang.Object,java.lang.Object)>
<com.matt_richardson.gocd.websocket_notifier.GoNotificationPlugin: com.thoughtworks.go.plugin.api.response.GoPluginApiResponse renderJSON(int,java.lang.Object)>/com.google.gson.GsonBuilder.create/0	<com.google.gson.GsonBuilder: com.google.gson.Gson create()>
<com.matt_richardson.gocd.websocket_notifier.GoNotificationPlugin: com.thoughtworks.go.plugin.api.response.GoPluginApiResponse renderJSON(int,java.lang.Object)>/com.google.gson.Gson.toJson/0	<com.google.gson.Gson: java.lang.String toJson(java.lang.Object)>
<com.matt_richardson.gocd.websocket_notifier.PluginConfig: void <init>()>/java.lang.StringBuilder.append/0	<java.lang.StringBuilder: java.lang.StringBuilder append(java.lang.String)>
<com.matt_richardson.gocd.websocket_notifier.PluginConfig: void <init>()>/java.lang.StringBuilder.append/1	<java.lang.StringBuilder: java.lang.StringBuilder append(java.lang.String)>
<com.matt_richardson.gocd.websocket_notifier.PluginConfig: void <init>()>/java.lang.StringBuilder.append/2	<java.lang.StringBuilder: java.lang.StringBuilder append(java.lang.String)>
<com.matt_richardson.gocd.websocket_notifier.PluginConfig: void <init>()>/java.lang.StringBuilder.toString/0	<java.lang.StringBuilder: java.lang.String toString()>
<com.matt_richardson.gocd.websocket_notifier.PluginConfig: void <init>()>/java.io.File.exists/0	<java.io.File: boolean exists()>
<com.matt_richardson.gocd.websocket_notifier.PluginConfig: void <init>()>/com.thoughtworks.go.plugin.api.logging.Logger.warn/0	<com.thoughtworks.go.plugin.api.logging.Logger: void warn(java.lang.String)>
<com.matt_richardson.gocd.websocket_notifier.PluginConfig: void <init>()>/com.typesafe.config.Config.hasPath/0	<com.typesafe.config.Config: boolean hasPath(java.lang.String)>
<com.matt_richardson.gocd.websocket_notifier.PluginConfig: void <init>()>/com.typesafe.config.Config.getInt/0	<com.typesafe.config.Config: int getInt(java.lang.String)>
<com.matt_richardson.gocd.websocket_notifier.PluginConfig: void <init>()>/com.matt_richardson.gocd.websocket_notifier.PluginConfig.setPort/0	<com.matt_richardson.gocd.websocket_notifier.PluginConfig: void setPort(int)>
<com.matt_richardson.gocd.websocket_notifier.PluginConfig: void <init>()>/com.typesafe.config.Config.hasPath/1	<com.typesafe.config.Config: boolean hasPath(java.lang.String)>
<com.matt_richardson.gocd.websocket_notifier.PluginConfig: void <init>()>/com.typesafe.config.Config.getString/0	<com.typesafe.config.Config: java.lang.String getString(java.lang.String)>
<com.matt_richardson.gocd.websocket_notifier.PluginConfig: void <init>()>/com.matt_richardson.gocd.websocket_notifier.PluginConfig.setHost/0	<com.matt_richardson.gocd.websocket_notifier.PluginConfig: void setHost(java.lang.String)>
<com.matt_richardson.gocd.websocket_notifier.PluginConfig: void <init>()>/com.typesafe.config.Config.hasPath/2	<com.typesafe.config.Config: boolean hasPath(java.lang.String)>
<com.matt_richardson.gocd.websocket_notifier.PluginConfig: void <init>()>/com.typesafe.config.Config.getInt/1	<com.typesafe.config.Config: int getInt(java.lang.String)>
<com.matt_richardson.gocd.websocket_notifier.PluginConfig: void <init>()>/com.matt_richardson.gocd.websocket_notifier.PluginConfig.setGoHttpPort/0	<com.matt_richardson.gocd.websocket_notifier.PluginConfig: void setGoHttpPort(int)>
<com.matt_richardson.gocd.websocket_notifier.PluginConfig: void <init>()>/com.typesafe.config.Config.hasPath/3	<com.typesafe.config.Config: boolean hasPath(java.lang.String)>
<com.matt_richardson.gocd.websocket_notifier.PluginConfig: void <init>()>/com.typesafe.config.Config.getString/1	<com.typesafe.config.Config: java.lang.String getString(java.lang.String)>
<com.matt_richardson.gocd.websocket_notifier.PluginConfig: void <init>()>/com.matt_richardson.gocd.websocket_notifier.PluginConfig.setGoUser/0	<com.matt_richardson.gocd.websocket_notifier.PluginConfig: void setGoUser(java.lang.String)>
<com.matt_richardson.gocd.websocket_notifier.PluginConfig: void <init>()>/com.typesafe.config.Config.hasPath/4	<com.typesafe.config.Config: boolean hasPath(java.lang.String)>
<com.matt_richardson.gocd.websocket_notifier.PluginConfig: void <init>()>/com.typesafe.config.Config.getString/2	<com.typesafe.config.Config: java.lang.String getString(java.lang.String)>
<com.matt_richardson.gocd.websocket_notifier.PluginConfig: void <init>()>/com.matt_richardson.gocd.websocket_notifier.PluginConfig.setGoPassword/0	<com.matt_richardson.gocd.websocket_notifier.PluginConfig: void setGoPassword(java.lang.String)>
<com.matt_richardson.gocd.websocket_notifier.PluginConfig: boolean isHostSet()>/java.lang.String.isEmpty/0	<java.lang.String: boolean isEmpty()>
<com.matt_richardson.gocd.websocket_notifier.PluginConfig: boolean hasBasicAuth()>/com.matt_richardson.gocd.websocket_notifier.PluginConfig.isGoUserSet/0	<com.matt_richardson.gocd.websocket_notifier.PluginConfig: boolean isGoUserSet()>
<com.matt_richardson.gocd.websocket_notifier.PluginConfig: boolean hasBasicAuth()>/com.matt_richardson.gocd.websocket_notifier.PluginConfig.isGoPasswordSet/0	<com.matt_richardson.gocd.websocket_notifier.PluginConfig: boolean isGoPasswordSet()>
<com.matt_richardson.gocd.websocket_notifier.WebSocketPipelineListener: void notify(com.thoughtworks.go.plugin.api.request.GoPluginApiRequest)>/java.lang.StringBuilder.append/0	<java.lang.StringBuilder: java.lang.StringBuilder append(java.lang.String)>
<com.matt_richardson.gocd.websocket_notifier.WebSocketPipelineListener: void notify(com.thoughtworks.go.plugin.api.request.GoPluginApiRequest)>/com.thoughtworks.go.plugin.api.request.GoPluginApiRequest.requestName/0	<com.thoughtworks.go.plugin.api.request.GoPluginApiRequest: java.lang.String requestName()>
<com.matt_richardson.gocd.websocket_notifier.WebSocketPipelineListener: void notify(com.thoughtworks.go.plugin.api.request.GoPluginApiRequest)>/java.lang.StringBuilder.append/1	<java.lang.StringBuilder: java.lang.StringBuilder append(java.lang.String)>
<com.matt_richardson.gocd.websocket_notifier.WebSocketPipelineListener: void notify(com.thoughtworks.go.plugin.api.request.GoPluginApiRequest)>/java.lang.StringBuilder.append/2	<java.lang.StringBuilder: java.lang.StringBuilder append(java.lang.String)>
<com.matt_richardson.gocd.websocket_notifier.WebSocketPipelineListener: void notify(com.thoughtworks.go.plugin.api.request.GoPluginApiRequest)>/com.thoughtworks.go.plugin.api.request.GoPluginApiRequest.requestBody/0	<com.thoughtworks.go.plugin.api.request.GoPluginApiRequest: java.lang.String requestBody()>
<com.matt_richardson.gocd.websocket_notifier.WebSocketPipelineListener: void notify(com.thoughtworks.go.plugin.api.request.GoPluginApiRequest)>/java.lang.StringBuilder.append/3	<java.lang.StringBuilder: java.lang.StringBuilder append(java.lang.String)>
<com.matt_richardson.gocd.websocket_notifier.WebSocketPipelineListener: void notify(com.thoughtworks.go.plugin.api.request.GoPluginApiRequest)>/java.lang.StringBuilder.append/4	<java.lang.StringBuilder: java.lang.StringBuilder append(java.lang.String)>
<com.matt_richardson.gocd.websocket_notifier.WebSocketPipelineListener: void notify(com.thoughtworks.go.plugin.api.request.GoPluginApiRequest)>/java.lang.StringBuilder.toString/0	<java.lang.StringBuilder: java.lang.String toString()>
<com.matt_richardson.gocd.websocket_notifier.WebSocketPipelineListener: void notify(com.thoughtworks.go.plugin.api.request.GoPluginApiRequest)>/com.thoughtworks.go.plugin.api.logging.Logger.info/0	<com.thoughtworks.go.plugin.api.logging.Logger: void info(java.lang.String)>
<com.matt_richardson.gocd.websocket_notifier.WebSocketPipelineListener: void notify(com.thoughtworks.go.plugin.api.request.GoPluginApiRequest)>/com.thoughtworks.go.plugin.api.request.GoPluginApiRequest.requestBody/1	<com.thoughtworks.go.plugin.api.request.GoPluginApiRequest: java.lang.String requestBody()>
<com.matt_richardson.gocd.websocket_notifier.WebSocketPipelineListener: void notify(com.thoughtworks.go.plugin.api.request.GoPluginApiRequest)>/com.matt_richardson.gocd.websocket_notifier.PipelineDetailsPopulator.extendMessageToIncludePipelineDetails/0	<com.matt_richardson.gocd.websocket_notifier.PipelineDetailsPopulator: java.lang.String extendMessageToIncludePipelineDetails(java.lang.String)>
<com.matt_richardson.gocd.websocket_notifier.WebSocketPipelineListener: void notify(com.thoughtworks.go.plugin.api.request.GoPluginApiRequest)>/com.matt_richardson.gocd.websocket_notifier.PipelineWebSocketServer.sendToAll/0	<com.matt_richardson.gocd.websocket_notifier.PipelineWebSocketServer: void sendToAll(java.lang.String)>
<com.matt_richardson.gocd.websocket_notifier.PipelineDetailsPopulator: java.lang.String mergeInPipelineInstanceDetails(com.google.gson.JsonElement,com.google.gson.JsonElement)>/com.google.gson.JsonElement.getAsJsonObject/0	<com.google.gson.JsonElement: com.google.gson.JsonObject getAsJsonObject()>
<com.matt_richardson.gocd.websocket_notifier.PipelineDetailsPopulator: java.lang.String mergeInPipelineInstanceDetails(com.google.gson.JsonElement,com.google.gson.JsonElement)>/com.google.gson.JsonObject.add/0	<com.google.gson.JsonObject: void add(java.lang.String,com.google.gson.JsonElement)>
<com.matt_richardson.gocd.websocket_notifier.PipelineDetailsPopulator: java.lang.String mergeInPipelineInstanceDetails(com.google.gson.JsonElement,com.google.gson.JsonElement)>/com.google.gson.JsonObject.toString/0	<com.google.gson.JsonObject: java.lang.String toString()>
<com.matt_richardson.gocd.websocket_notifier.PipelineDetailsPopulator: com.google.gson.JsonElement downloadPipelineInstanceDetails(java.lang.String)>/com.matt_richardson.gocd.websocket_notifier.PluginConfig.getGoHttpPort/0	<com.matt_richardson.gocd.websocket_notifier.PluginConfig: int getGoHttpPort()>
<com.matt_richardson.gocd.websocket_notifier.PipelineDetailsPopulator: com.google.gson.JsonElement downloadPipelineInstanceDetails(java.lang.String)>/java.lang.StringBuilder.append/0	<java.lang.StringBuilder: java.lang.StringBuilder append(java.lang.String)>
<com.matt_richardson.gocd.websocket_notifier.PipelineDetailsPopulator: com.google.gson.JsonElement downloadPipelineInstanceDetails(java.lang.String)>/java.lang.StringBuilder.append/1	<java.lang.StringBuilder: java.lang.StringBuilder append(int)>
<com.matt_richardson.gocd.websocket_notifier.PipelineDetailsPopulator: com.google.gson.JsonElement downloadPipelineInstanceDetails(java.lang.String)>/java.lang.StringBuilder.append/2	<java.lang.StringBuilder: java.lang.StringBuilder append(java.lang.String)>
<com.matt_richardson.gocd.websocket_notifier.PipelineDetailsPopulator: com.google.gson.JsonElement downloadPipelineInstanceDetails(java.lang.String)>/java.lang.StringBuilder.append/3	<java.lang.StringBuilder: java.lang.StringBuilder append(java.lang.String)>
<com.matt_richardson.gocd.websocket_notifier.PipelineDetailsPopulator: com.google.gson.JsonElement downloadPipelineInstanceDetails(java.lang.String)>/java.lang.StringBuilder.append/4	<java.lang.StringBuilder: java.lang.StringBuilder append(java.lang.String)>
<com.matt_richardson.gocd.websocket_notifier.PipelineDetailsPopulator: com.google.gson.JsonElement downloadPipelineInstanceDetails(java.lang.String)>/java.lang.StringBuilder.toString/0	<java.lang.StringBuilder: java.lang.String toString()>
<com.matt_richardson.gocd.websocket_notifier.PipelineDetailsPopulator: com.google.gson.JsonElement downloadPipelineInstanceDetails(java.lang.String)>/java.net.URL.openConnection/0	<java.net.URL: java.net.URLConnection openConnection()>
<com.matt_richardson.gocd.websocket_notifier.PipelineDetailsPopulator: com.google.gson.JsonElement downloadPipelineInstanceDetails(java.lang.String)>/com.matt_richardson.gocd.websocket_notifier.PluginConfig.hasBasicAuth/0	<com.matt_richardson.gocd.websocket_notifier.PluginConfig: boolean hasBasicAuth()>
<com.matt_richardson.gocd.websocket_notifier.PipelineDetailsPopulator: com.google.gson.JsonElement downloadPipelineInstanceDetails(java.lang.String)>/com.matt_richardson.gocd.websocket_notifier.PluginConfig.getGoUser/0	<com.matt_richardson.gocd.websocket_notifier.PluginConfig: java.lang.String getGoUser()>
<com.matt_richardson.gocd.websocket_notifier.PipelineDetailsPopulator: com.google.gson.JsonElement downloadPipelineInstanceDetails(java.lang.String)>/com.matt_richardson.gocd.websocket_notifier.PluginConfig.getGoPassword/0	<com.matt_richardson.gocd.websocket_notifier.PluginConfig: java.lang.String getGoPassword()>
<com.matt_richardson.gocd.websocket_notifier.PipelineDetailsPopulator: com.google.gson.JsonElement downloadPipelineInstanceDetails(java.lang.String)>/java.lang.StringBuilder.append/5	<java.lang.StringBuilder: java.lang.StringBuilder append(java.lang.String)>
<com.matt_richardson.gocd.websocket_notifier.PipelineDetailsPopulator: com.google.gson.JsonElement downloadPipelineInstanceDetails(java.lang.String)>/java.lang.StringBuilder.append/6	<java.lang.StringBuilder: java.lang.StringBuilder append(java.lang.String)>
<com.matt_richardson.gocd.websocket_notifier.PipelineDetailsPopulator: com.google.gson.JsonElement downloadPipelineInstanceDetails(java.lang.String)>/java.lang.StringBuilder.append/7	<java.lang.StringBuilder: java.lang.StringBuilder append(java.lang.String)>
<com.matt_richardson.gocd.websocket_notifier.PipelineDetailsPopulator: com.google.gson.JsonElement downloadPipelineInstanceDetails(java.lang.String)>/java.lang.StringBuilder.toString/1	<java.lang.StringBuilder: java.lang.String toString()>
<com.matt_richardson.gocd.websocket_notifier.PipelineDetailsPopulator: com.google.gson.JsonElement downloadPipelineInstanceDetails(java.lang.String)>/java.lang.String.getBytes/0	<java.lang.String: byte[] getBytes()>
<com.matt_richardson.gocd.websocket_notifier.PipelineDetailsPopulator: com.google.gson.JsonElement downloadPipelineInstanceDetails(java.lang.String)>/java.lang.StringBuilder.append/8	<java.lang.StringBuilder: java.lang.StringBuilder append(java.lang.String)>
<com.matt_richardson.gocd.websocket_notifier.PipelineDetailsPopulator: com.google.gson.JsonElement downloadPipelineInstanceDetails(java.lang.String)>/java.lang.StringBuilder.append/9	<java.lang.StringBuilder: java.lang.StringBuilder append(java.lang.String)>
<com.matt_richardson.gocd.websocket_notifier.PipelineDetailsPopulator: com.google.gson.JsonElement downloadPipelineInstanceDetails(java.lang.String)>/java.lang.StringBuilder.toString/2	<java.lang.StringBuilder: java.lang.String toString()>
<com.matt_richardson.gocd.websocket_notifier.PipelineDetailsPopulator: com.google.gson.JsonElement downloadPipelineInstanceDetails(java.lang.String)>/java.net.HttpURLConnection.setRequestProperty/0	<java.net.URLConnection: void setRequestProperty(java.lang.String,java.lang.String)>
<com.matt_richardson.gocd.websocket_notifier.PipelineDetailsPopulator: com.google.gson.JsonElement downloadPipelineInstanceDetails(java.lang.String)>/java.net.HttpURLConnection.connect/0	<java.net.URLConnection: void connect()>
<com.matt_richardson.gocd.websocket_notifier.PipelineDetailsPopulator: com.google.gson.JsonElement downloadPipelineInstanceDetails(java.lang.String)>/java.net.HttpURLConnection.getContent/0	<java.net.URLConnection: java.lang.Object getContent()>
<com.matt_richardson.gocd.websocket_notifier.PipelineDetailsPopulator: com.google.gson.JsonElement downloadPipelineInstanceDetails(java.lang.String)>/com.google.gson.JsonParser.parse/0	<com.google.gson.JsonParser: com.google.gson.JsonElement parse(java.io.Reader)>
<com.matt_richardson.gocd.websocket_notifier.PipelineDetailsPopulator: com.google.gson.JsonElement downloadPipelineInstanceDetails(java.lang.String)>/com.google.gson.JsonElement.getAsJsonObject/0	<com.google.gson.JsonElement: com.google.gson.JsonObject getAsJsonObject()>
<com.matt_richardson.gocd.websocket_notifier.PipelineDetailsPopulator: com.google.gson.JsonElement downloadPipelineInstanceDetails(java.lang.String)>/com.google.gson.JsonObject.get/0	<com.google.gson.JsonObject: com.google.gson.JsonElement get(java.lang.String)>
<com.matt_richardson.gocd.websocket_notifier.PipelineDetailsPopulator: com.google.gson.JsonElement downloadPipelineInstanceDetails(java.lang.String)>/com.google.gson.JsonElement.getAsJsonArray/0	<com.google.gson.JsonElement: com.google.gson.JsonArray getAsJsonArray()>
<com.matt_richardson.gocd.websocket_notifier.PipelineDetailsPopulator: com.google.gson.JsonElement downloadPipelineInstanceDetails(java.lang.String)>/com.google.gson.JsonArray.get/0	<com.google.gson.JsonArray: com.google.gson.JsonElement get(int)>
<com.matt_richardson.gocd.websocket_notifier.PipelineDetailsPopulator: java.lang.String extendMessageToIncludePipelineDetails(java.lang.String)>/com.google.gson.JsonParser.parse/0	<com.google.gson.JsonParser: com.google.gson.JsonElement parse(java.lang.String)>
<com.matt_richardson.gocd.websocket_notifier.PipelineDetailsPopulator: java.lang.String extendMessageToIncludePipelineDetails(java.lang.String)>/com.google.gson.JsonElement.getAsJsonObject/0	<com.google.gson.JsonElement: com.google.gson.JsonObject getAsJsonObject()>
<com.matt_richardson.gocd.websocket_notifier.PipelineDetailsPopulator: java.lang.String extendMessageToIncludePipelineDetails(java.lang.String)>/com.google.gson.JsonObject.get/0	<com.google.gson.JsonObject: com.google.gson.JsonElement get(java.lang.String)>
<com.matt_richardson.gocd.websocket_notifier.PipelineDetailsPopulator: java.lang.String extendMessageToIncludePipelineDetails(java.lang.String)>/com.google.gson.JsonObject.get/1	<com.google.gson.JsonObject: com.google.gson.JsonElement get(java.lang.String)>
<com.matt_richardson.gocd.websocket_notifier.PipelineDetailsPopulator: java.lang.String extendMessageToIncludePipelineDetails(java.lang.String)>/com.google.gson.JsonElement.getAsJsonObject/1	<com.google.gson.JsonElement: com.google.gson.JsonObject getAsJsonObject()>
<com.matt_richardson.gocd.websocket_notifier.PipelineDetailsPopulator: java.lang.String extendMessageToIncludePipelineDetails(java.lang.String)>/com.google.gson.JsonObject.get/2	<com.google.gson.JsonObject: com.google.gson.JsonElement get(java.lang.String)>
<com.matt_richardson.gocd.websocket_notifier.PipelineDetailsPopulator: java.lang.String extendMessageToIncludePipelineDetails(java.lang.String)>/com.google.gson.JsonElement.getAsString/0	<com.google.gson.JsonElement: java.lang.String getAsString()>
<com.matt_richardson.gocd.websocket_notifier.PipelineDetailsPopulator: java.lang.String extendMessageToIncludePipelineDetails(java.lang.String)>/com.matt_richardson.gocd.websocket_notifier.PipelineDetailsPopulator.downloadPipelineInstanceDetails/0	<com.matt_richardson.gocd.websocket_notifier.PipelineDetailsPopulator: com.google.gson.JsonElement downloadPipelineInstanceDetails(java.lang.String)>
<com.matt_richardson.gocd.websocket_notifier.PipelineDetailsPopulator: java.lang.String extendMessageToIncludePipelineDetails(java.lang.String)>/com.matt_richardson.gocd.websocket_notifier.PipelineDetailsPopulator.mergeInPipelineInstanceDetails/0	<com.matt_richardson.gocd.websocket_notifier.PipelineDetailsPopulator: java.lang.String mergeInPipelineInstanceDetails(com.google.gson.JsonElement,com.google.gson.JsonElement)>
<com.matt_richardson.gocd.websocket_notifier.PipelineDetailsPopulator: java.lang.String extendMessageToIncludePipelineDetails(java.lang.String)>/java.lang.StringBuilder.append/0	<java.lang.StringBuilder: java.lang.StringBuilder append(java.lang.String)>
<com.matt_richardson.gocd.websocket_notifier.PipelineDetailsPopulator: java.lang.String extendMessageToIncludePipelineDetails(java.lang.String)>/java.lang.StringBuilder.append/1	<java.lang.StringBuilder: java.lang.StringBuilder append(java.lang.String)>
<com.matt_richardson.gocd.websocket_notifier.PipelineDetailsPopulator: java.lang.String extendMessageToIncludePipelineDetails(java.lang.String)>/java.lang.StringBuilder.append/2	<java.lang.StringBuilder: java.lang.StringBuilder append(java.lang.String)>
<com.matt_richardson.gocd.websocket_notifier.PipelineDetailsPopulator: java.lang.String extendMessageToIncludePipelineDetails(java.lang.String)>/java.lang.StringBuilder.toString/0	<java.lang.StringBuilder: java.lang.String toString()>
<com.matt_richardson.gocd.websocket_notifier.PipelineDetailsPopulator: java.lang.String extendMessageToIncludePipelineDetails(java.lang.String)>/com.thoughtworks.go.plugin.api.logging.Logger.error/0	<com.thoughtworks.go.plugin.api.logging.Logger: void error(java.lang.String,java.lang.Throwable)>
<com.matt_richardson.gocd.websocket_notifier.PipelineWebSocketServer: void <init>(int)>/java.net.InetSocketAddress.<init>/0	<java.net.InetSocketAddress: void <init>(int)>
<com.matt_richardson.gocd.websocket_notifier.PipelineWebSocketServer: void <init>(int)>/org.java_websocket.server.WebSocketServer.<init>/0	<org.java_websocket.server.WebSocketServer: void <init>(java.net.InetSocketAddress)>
<com.matt_richardson.gocd.websocket_notifier.PipelineWebSocketServer: void <init>(java.lang.String,int)>/java.net.InetSocketAddress.<init>/0	<java.net.InetSocketAddress: void <init>(java.lang.String,int)>
<com.matt_richardson.gocd.websocket_notifier.PipelineWebSocketServer: void <init>(java.lang.String,int)>/org.java_websocket.server.WebSocketServer.<init>/0	<org.java_websocket.server.WebSocketServer: void <init>(java.net.InetSocketAddress)>
<com.matt_richardson.gocd.websocket_notifier.PipelineWebSocketServer: void onOpen(org.java_websocket.WebSocket,org.java_websocket.handshake.ClientHandshake)>/java.lang.StringBuilder.<init>/0	<java.lang.StringBuilder: void <init>()>
<com.matt_richardson.gocd.websocket_notifier.PipelineWebSocketServer: void onClose(org.java_websocket.WebSocket,int,java.lang.String,boolean)>/java.lang.StringBuilder.<init>/0	<java.lang.StringBuilder: void <init>()>
<com.matt_richardson.gocd.websocket_notifier.PipelineWebSocketServer: void sendToAll(java.lang.String)>/java.lang.StringBuilder.<init>/0	<java.lang.StringBuilder: void <init>()>
<com.matt_richardson.gocd.websocket_notifier.GoNotificationPlugin: void initializeGoApplicationAccessor(com.thoughtworks.go.plugin.api.GoApplicationAccessor)>/com.matt_richardson.gocd.websocket_notifier.PluginConfig.<init>/0	<com.matt_richardson.gocd.websocket_notifier.PluginConfig: void <init>()>
<com.matt_richardson.gocd.websocket_notifier.GoNotificationPlugin: void initializeGoApplicationAccessor(com.thoughtworks.go.plugin.api.GoApplicationAccessor)>/java.lang.StringBuilder.<init>/0	<java.lang.StringBuilder: void <init>()>
<com.matt_richardson.gocd.websocket_notifier.GoNotificationPlugin: void initializeGoApplicationAccessor(com.thoughtworks.go.plugin.api.GoApplicationAccessor)>/com.matt_richardson.gocd.websocket_notifier.PipelineWebSocketServer.<init>/0	<com.matt_richardson.gocd.websocket_notifier.PipelineWebSocketServer: void <init>(java.lang.String,int)>
<com.matt_richardson.gocd.websocket_notifier.GoNotificationPlugin: void initializeGoApplicationAccessor(com.thoughtworks.go.plugin.api.GoApplicationAccessor)>/com.matt_richardson.gocd.websocket_notifier.PipelineWebSocketServer.<init>/1	<com.matt_richardson.gocd.websocket_notifier.PipelineWebSocketServer: void <init>(int)>
<com.matt_richardson.gocd.websocket_notifier.GoNotificationPlugin: void initializeGoApplicationAccessor(com.thoughtworks.go.plugin.api.GoApplicationAccessor)>/java.lang.StringBuilder.<init>/1	<java.lang.StringBuilder: void <init>()>
<com.matt_richardson.gocd.websocket_notifier.GoNotificationPlugin: void initializeGoApplicationAccessor(com.thoughtworks.go.plugin.api.GoApplicationAccessor)>/com.matt_richardson.gocd.websocket_notifier.WebSocketPipelineListener.<init>/0	<com.matt_richardson.gocd.websocket_notifier.WebSocketPipelineListener: void <init>(com.matt_richardson.gocd.websocket_notifier.PipelineWebSocketServer,com.matt_richardson.gocd.websocket_notifier.PluginConfig)>
<com.matt_richardson.gocd.websocket_notifier.GoNotificationPlugin: void initializeGoApplicationAccessor(com.thoughtworks.go.plugin.api.GoApplicationAccessor)>/java.lang.StringBuilder.<init>/2	<java.lang.StringBuilder: void <init>()>
<com.matt_richardson.gocd.websocket_notifier.GoNotificationPlugin: void <init>()>/java.lang.Object.<init>/0	<java.lang.Object: void <init>()>
<com.matt_richardson.gocd.websocket_notifier.GoNotificationPlugin: void <init>(com.matt_richardson.gocd.websocket_notifier.WebSocketPipelineListener)>/java.lang.Object.<init>/0	<java.lang.Object: void <init>()>
<com.matt_richardson.gocd.websocket_notifier.GoNotificationPlugin: com.thoughtworks.go.plugin.api.response.GoPluginApiResponse handle(com.thoughtworks.go.plugin.api.request.GoPluginApiRequest)>/java.lang.StringBuilder.<init>/0	<java.lang.StringBuilder: void <init>()>
<com.matt_richardson.gocd.websocket_notifier.GoNotificationPlugin: com.thoughtworks.go.plugin.api.response.GoPluginApiResponse handle(com.thoughtworks.go.plugin.api.request.GoPluginApiRequest)>/com.matt_richardson.gocd.websocket_notifier.GoNotificationPlugin.handleNotificationsInterestedIn/0	<com.matt_richardson.gocd.websocket_notifier.GoNotificationPlugin: com.thoughtworks.go.plugin.api.response.GoPluginApiResponse handleNotificationsInterestedIn()>
<com.matt_richardson.gocd.websocket_notifier.GoNotificationPlugin: com.thoughtworks.go.plugin.api.response.GoPluginApiResponse handle(com.thoughtworks.go.plugin.api.request.GoPluginApiRequest)>/com.matt_richardson.gocd.websocket_notifier.GoNotificationPlugin.handleStageNotification/0	<com.matt_richardson.gocd.websocket_notifier.GoNotificationPlugin: com.thoughtworks.go.plugin.api.response.GoPluginApiResponse handleStageNotification(com.thoughtworks.go.plugin.api.request.GoPluginApiRequest)>
<com.matt_richardson.gocd.websocket_notifier.GoNotificationPlugin: com.thoughtworks.go.plugin.api.response.GoPluginApiResponse handle(com.thoughtworks.go.plugin.api.request.GoPluginApiRequest)>/java.lang.StringBuilder.<init>/1	<java.lang.StringBuilder: void <init>()>
<com.matt_richardson.gocd.websocket_notifier.GoNotificationPlugin: com.thoughtworks.go.plugin.api.GoPluginIdentifier pluginIdentifier()>/com.thoughtworks.go.plugin.api.GoPluginIdentifier.<init>/0	<com.thoughtworks.go.plugin.api.GoPluginIdentifier: void <init>(java.lang.String,java.util.List)>
<com.matt_richardson.gocd.websocket_notifier.GoNotificationPlugin: com.thoughtworks.go.plugin.api.response.GoPluginApiResponse handleNotificationsInterestedIn()>/java.util.HashMap.<init>/0	<java.util.HashMap: void <init>()>
<com.matt_richardson.gocd.websocket_notifier.GoNotificationPlugin: com.thoughtworks.go.plugin.api.response.GoPluginApiResponse handleNotificationsInterestedIn()>/com.matt_richardson.gocd.websocket_notifier.GoNotificationPlugin.renderJSON/0	<com.matt_richardson.gocd.websocket_notifier.GoNotificationPlugin: com.thoughtworks.go.plugin.api.response.GoPluginApiResponse renderJSON(int,java.lang.Object)>
<com.matt_richardson.gocd.websocket_notifier.GoNotificationPlugin: com.thoughtworks.go.plugin.api.response.GoPluginApiResponse handleStageNotification(com.thoughtworks.go.plugin.api.request.GoPluginApiRequest)>/java.util.HashMap.<init>/0	<java.util.HashMap: void <init>()>
<com.matt_richardson.gocd.websocket_notifier.GoNotificationPlugin: com.thoughtworks.go.plugin.api.response.GoPluginApiResponse handleStageNotification(com.thoughtworks.go.plugin.api.request.GoPluginApiRequest)>/java.util.ArrayList.<init>/0	<java.util.ArrayList: void <init>()>
<com.matt_richardson.gocd.websocket_notifier.GoNotificationPlugin: com.thoughtworks.go.plugin.api.response.GoPluginApiResponse handleStageNotification(com.thoughtworks.go.plugin.api.request.GoPluginApiRequest)>/com.matt_richardson.gocd.websocket_notifier.GoNotificationPlugin.renderJSON/0	<com.matt_richardson.gocd.websocket_notifier.GoNotificationPlugin: com.thoughtworks.go.plugin.api.response.GoPluginApiResponse renderJSON(int,java.lang.Object)>
<com.matt_richardson.gocd.websocket_notifier.GoNotificationPlugin: com.thoughtworks.go.plugin.api.response.GoPluginApiResponse renderJSON(int,java.lang.Object)>/com.google.gson.GsonBuilder.<init>/0	<com.google.gson.GsonBuilder: void <init>()>
<com.matt_richardson.gocd.websocket_notifier.GoNotificationPlugin: com.thoughtworks.go.plugin.api.response.GoPluginApiResponse renderJSON(int,java.lang.Object)>/com.matt_richardson.gocd.websocket_notifier.GoNotificationPlugin$1.<init>/0	<com.matt_richardson.gocd.websocket_notifier.GoNotificationPlugin$1: void <init>(com.matt_richardson.gocd.websocket_notifier.GoNotificationPlugin,int,java.lang.String)>
<com.matt_richardson.gocd.websocket_notifier.GoNotificationPlugin$1: void <init>(com.matt_richardson.gocd.websocket_notifier.GoNotificationPlugin,int,java.lang.String)>/com.thoughtworks.go.plugin.api.response.GoPluginApiResponse.<init>/0	<com.thoughtworks.go.plugin.api.response.GoPluginApiResponse: void <init>()>
<com.matt_richardson.gocd.websocket_notifier.PluginConfig: void <init>()>/java.lang.Object.<init>/0	<java.lang.Object: void <init>()>
<com.matt_richardson.gocd.websocket_notifier.PluginConfig: void <init>()>/java.lang.StringBuilder.<init>/0	<java.lang.StringBuilder: void <init>()>
<com.matt_richardson.gocd.websocket_notifier.PluginConfig: void <init>()>/java.io.File.<init>/0	<java.io.File: void <init>(java.lang.String)>
<com.matt_richardson.gocd.websocket_notifier.WebSocketPipelineListener: void <init>(com.matt_richardson.gocd.websocket_notifier.PipelineWebSocketServer,com.matt_richardson.gocd.websocket_notifier.PluginConfig)>/java.lang.Object.<init>/0	<java.lang.Object: void <init>()>
<com.matt_richardson.gocd.websocket_notifier.WebSocketPipelineListener: void <init>(com.matt_richardson.gocd.websocket_notifier.PipelineWebSocketServer,com.matt_richardson.gocd.websocket_notifier.PluginConfig)>/com.matt_richardson.gocd.websocket_notifier.PipelineDetailsPopulator.<init>/0	<com.matt_richardson.gocd.websocket_notifier.PipelineDetailsPopulator: void <init>(com.matt_richardson.gocd.websocket_notifier.PluginConfig)>
<com.matt_richardson.gocd.websocket_notifier.WebSocketPipelineListener: void notify(com.thoughtworks.go.plugin.api.request.GoPluginApiRequest)>/java.lang.StringBuilder.<init>/0	<java.lang.StringBuilder: void <init>()>
<com.matt_richardson.gocd.websocket_notifier.PipelineDetailsPopulator: void <init>(com.matt_richardson.gocd.websocket_notifier.PluginConfig)>/java.lang.Object.<init>/0	<java.lang.Object: void <init>()>
<com.matt_richardson.gocd.websocket_notifier.PipelineDetailsPopulator: com.google.gson.JsonElement downloadPipelineInstanceDetails(java.lang.String)>/java.lang.StringBuilder.<init>/0	<java.lang.StringBuilder: void <init>()>
<com.matt_richardson.gocd.websocket_notifier.PipelineDetailsPopulator: com.google.gson.JsonElement downloadPipelineInstanceDetails(java.lang.String)>/java.net.URL.<init>/0	<java.net.URL: void <init>(java.lang.String)>
<com.matt_richardson.gocd.websocket_notifier.PipelineDetailsPopulator: com.google.gson.JsonElement downloadPipelineInstanceDetails(java.lang.String)>/java.lang.StringBuilder.<init>/1	<java.lang.StringBuilder: void <init>()>
<com.matt_richardson.gocd.websocket_notifier.PipelineDetailsPopulator: com.google.gson.JsonElement downloadPipelineInstanceDetails(java.lang.String)>/java.lang.String.<init>/0	<java.lang.String: void <init>(byte[])>
<com.matt_richardson.gocd.websocket_notifier.PipelineDetailsPopulator: com.google.gson.JsonElement downloadPipelineInstanceDetails(java.lang.String)>/java.lang.StringBuilder.<init>/2	<java.lang.StringBuilder: void <init>()>
<com.matt_richardson.gocd.websocket_notifier.PipelineDetailsPopulator: com.google.gson.JsonElement downloadPipelineInstanceDetails(java.lang.String)>/com.google.gson.JsonParser.<init>/0	<com.google.gson.JsonParser: void <init>()>
<com.matt_richardson.gocd.websocket_notifier.PipelineDetailsPopulator: com.google.gson.JsonElement downloadPipelineInstanceDetails(java.lang.String)>/java.io.InputStreamReader.<init>/0	<java.io.InputStreamReader: void <init>(java.io.InputStream)>
<com.matt_richardson.gocd.websocket_notifier.PipelineDetailsPopulator: java.lang.String extendMessageToIncludePipelineDetails(java.lang.String)>/com.google.gson.JsonParser.<init>/0	<com.google.gson.JsonParser: void <init>()>
<com.matt_richardson.gocd.websocket_notifier.PipelineDetailsPopulator: java.lang.String extendMessageToIncludePipelineDetails(java.lang.String)>/java.lang.StringBuilder.<init>/0	<java.lang.StringBuilder: void <init>()>
<com.matt_richardson.gocd.websocket_notifier.PipelineWebSocketServer: void <init>(int)>/com.thoughtworks.go.plugin.api.logging.Logger.getLoggerFor/0	<com.thoughtworks.go.plugin.api.logging.Logger: com.thoughtworks.go.plugin.api.logging.Logger getLoggerFor(java.lang.Class)>
<com.matt_richardson.gocd.websocket_notifier.PipelineWebSocketServer: void <init>(java.lang.String,int)>/com.thoughtworks.go.plugin.api.logging.Logger.getLoggerFor/0	<com.thoughtworks.go.plugin.api.logging.Logger: com.thoughtworks.go.plugin.api.logging.Logger getLoggerFor(java.lang.Class)>
<com.matt_richardson.gocd.websocket_notifier.GoNotificationPlugin: com.thoughtworks.go.plugin.api.response.GoPluginApiResponse handle(com.thoughtworks.go.plugin.api.request.GoPluginApiRequest)>/com.thoughtworks.go.plugin.api.response.DefaultGoPluginApiResponse.badRequest/0	<com.thoughtworks.go.plugin.api.response.DefaultGoPluginApiResponse: com.thoughtworks.go.plugin.api.response.DefaultGoPluginApiResponse badRequest(java.lang.String)>
<com.matt_richardson.gocd.websocket_notifier.GoNotificationPlugin: com.thoughtworks.go.plugin.api.response.GoPluginApiResponse handle(com.thoughtworks.go.plugin.api.request.GoPluginApiRequest)>/java.lang.String.format/0	<java.lang.String: java.lang.String format(java.lang.String,java.lang.Object[])>
<com.matt_richardson.gocd.websocket_notifier.GoNotificationPlugin: com.thoughtworks.go.plugin.api.response.GoPluginApiResponse handle(com.thoughtworks.go.plugin.api.request.GoPluginApiRequest)>/com.thoughtworks.go.plugin.api.response.DefaultGoPluginApiResponse.error/0	<com.thoughtworks.go.plugin.api.response.DefaultGoPluginApiResponse: com.thoughtworks.go.plugin.api.response.DefaultGoPluginApiResponse error(java.lang.String)>
<com.matt_richardson.gocd.websocket_notifier.GoNotificationPlugin: com.thoughtworks.go.plugin.api.response.GoPluginApiResponse handleNotificationsInterestedIn()>/java.util.Arrays.asList/0	<java.util.Arrays: java.util.List asList(java.lang.Object[])>
<com.matt_richardson.gocd.websocket_notifier.GoNotificationPlugin: void <clinit>()>/com.thoughtworks.go.plugin.api.logging.Logger.getLoggerFor/0	<com.thoughtworks.go.plugin.api.logging.Logger: com.thoughtworks.go.plugin.api.logging.Logger getLoggerFor(java.lang.Class)>
<com.matt_richardson.gocd.websocket_notifier.GoNotificationPlugin: void <clinit>()>/java.util.Arrays.asList/0	<java.util.Arrays: java.util.List asList(java.lang.Object[])>
<com.matt_richardson.gocd.websocket_notifier.PluginConfig: void <init>()>/java.lang.System.getProperty/0	<java.lang.System: java.lang.String getProperty(java.lang.String)>
<com.matt_richardson.gocd.websocket_notifier.PluginConfig: void <init>()>/java.lang.String.format/0	<java.lang.String: java.lang.String format(java.lang.String,java.lang.Object[])>
<com.matt_richardson.gocd.websocket_notifier.PluginConfig: void <init>()>/com.typesafe.config.ConfigFactory.parseFile/0	<com.typesafe.config.ConfigFactory: com.typesafe.config.Config parseFile(java.io.File)>
<com.matt_richardson.gocd.websocket_notifier.PluginConfig: void <clinit>()>/com.thoughtworks.go.plugin.api.logging.Logger.getLoggerFor/0	<com.thoughtworks.go.plugin.api.logging.Logger: com.thoughtworks.go.plugin.api.logging.Logger getLoggerFor(java.lang.Class)>
<com.matt_richardson.gocd.websocket_notifier.WebSocketPipelineListener: void <init>(com.matt_richardson.gocd.websocket_notifier.PipelineWebSocketServer,com.matt_richardson.gocd.websocket_notifier.PluginConfig)>/com.thoughtworks.go.plugin.api.logging.Logger.getLoggerFor/0	<com.thoughtworks.go.plugin.api.logging.Logger: com.thoughtworks.go.plugin.api.logging.Logger getLoggerFor(java.lang.Class)>
<com.matt_richardson.gocd.websocket_notifier.PipelineDetailsPopulator: com.google.gson.JsonElement downloadPipelineInstanceDetails(java.lang.String)>/org.apache.commons.codec.binary.Base64.encodeBase64/0	<org.apache.commons.codec.binary.Base64: byte[] encodeBase64(byte[])>
<com.matt_richardson.gocd.websocket_notifier.PipelineDetailsPopulator: void <clinit>()>/com.thoughtworks.go.plugin.api.logging.Logger.getLoggerFor/0	<com.thoughtworks.go.plugin.api.logging.Logger: com.thoughtworks.go.plugin.api.logging.Logger getLoggerFor(java.lang.Class)>
