org.springframework.boot.loader.nio.file.NestedByteChannel$Resources	NestedByteChannel$Resources
stirling.software.SPDF.controller.api.ToSinglePageController	ToSinglePageController
stirling.software.SPDF.controller.api.pipeline.PipelineProcessor	PipelineProcessor
stirling.software.SPDF.controller.api.security.CertSignController$CreateSignature	CertSignController$CreateSignature
org.springframework.boot.loader.zip.ZipContent$Kind	ZipContent$Kind
org.springframework.boot.loader.zip.VirtualZipDataBlock$DataPart	VirtualZipDataBlock$DataPart
org.springframework.boot.loader.launch.JarFileArchive	JarFileArchive
stirling.software.SPDF.model.api.PDFWithImageFormatRequest	PDFWithImageFormatRequest
stirling.software.SPDF.model.ProviderInterface	ProviderInterface
stirling.software.SPDF.config.security.AppUpdateAuthService	AppUpdateAuthService
org.springframework.boot.loader.ref.Cleaner	Cleaner
stirling.software.SPDF.model.ApplicationProperties$AutoPipeline	ApplicationProperties$AutoPipeline
stirling.software.SPDF.controller.api.pipeline.PipelineProcessor$1	PipelineProcessor$1
stirling.software.SPDF.model.api.user.UpdateUserUsername	UpdateUserUsername
org.springframework.boot.loader.launch.PropertiesLauncher$Instantiator	PropertiesLauncher$Instantiator
stirling.software.SPDF.config.MetricsConfig$1	MetricsConfig$1
stirling.software.SPDF.model.api.misc.PrintFileRequest	PrintFileRequest
stirling.software.SPDF.controller.api.SplitPDFController	SplitPDFController
stirling.software.SPDF.utils.RequestUriUtils	RequestUriUtils
stirling.software.SPDF.controller.web.GeneralWebController	GeneralWebController
stirling.software.SPDF.model.api.general.CropPdfForm	CropPdfForm
stirling.software.SPDF.model.User	User
stirling.software.SPDF.controller.web.ConverterWebController	ConverterWebController
org.apache.pdfbox.examples.signature.CreateSignatureBase	CreateSignatureBase
org.springframework.boot.loader.jar.NestedJarFile$RawZipDataInputStream	NestedJarFile$RawZipDataInputStream
stirling.software.SPDF.model.ApiEndpoint	ApiEndpoint
stirling.software.SPDF.controller.web.SecurityWebController	SecurityWebController
stirling.software.SPDF.model.api.converters.PdfToWordRequest	PdfToWordRequest
stirling.software.SPDF.model.ApplicationProperties$GoogleProvider	ApplicationProperties$GoogleProvider
stirling.software.SPDF.controller.api.converters.ConvertPDFToPDFA	ConvertPDFToPDFA
stirling.software.SPDF.config.ConfigInitializer	ConfigInitializer
stirling.software.SPDF.model.api.general.RearrangePagesRequest	RearrangePagesRequest
org.springframework.boot.loader.zip.ByteArrayDataBlock	ByteArrayDataBlock
stirling.software.SPDF.model.api.misc.ExtractImageScansRequest	ExtractImageScansRequest
org.springframework.boot.loader.jarmode.JarMode	JarMode
org.springframework.boot.loader.zip.ZipLocalFileHeaderRecord	ZipLocalFileHeaderRecord
