<com.matt_richardson.gocd.websocket_notifier.GoNotificationPlugin: com.thoughtworks.go.plugin.api.GoPluginIdentifier pluginIdentifier()>/new com.thoughtworks.go.plugin.api.GoPluginIdentifier/0	com.thoughtworks.go.plugin.api.GoPluginIdentifier	0
<com.matt_richardson.gocd.websocket_notifier.GoNotificationPlugin: com.thoughtworks.go.plugin.api.response.GoPluginApiResponse handle(com.thoughtworks.go.plugin.api.request.GoPluginApiRequest)>/new java.lang.Object[]/0	java.lang.Object[]	10
<com.matt_richardson.gocd.websocket_notifier.GoNotificationPlugin: com.thoughtworks.go.plugin.api.response.GoPluginApiResponse handle(com.thoughtworks.go.plugin.api.request.GoPluginApiRequest)>/new java.lang.StringBuilder/0	java.lang.StringBuilder	0
<com.matt_richardson.gocd.websocket_notifier.GoNotificationPlugin: com.thoughtworks.go.plugin.api.response.GoPluginApiResponse handle(com.thoughtworks.go.plugin.api.request.GoPluginApiRequest)>/new java.lang.StringBuilder/1	java.lang.StringBuilder	10
<com.matt_richardson.gocd.websocket_notifier.GoNotificationPlugin: com.thoughtworks.go.plugin.api.response.GoPluginApiResponse handleNotificationsInterestedIn()>/new java.lang.String[]/0	java.lang.String[]	0
<com.matt_richardson.gocd.websocket_notifier.GoNotificationPlugin: com.thoughtworks.go.plugin.api.response.GoPluginApiResponse handleNotificationsInterestedIn()>/new java.util.HashMap/0	java.util.HashMap	0
<com.matt_richardson.gocd.websocket_notifier.GoNotificationPlugin: com.thoughtworks.go.plugin.api.response.GoPluginApiResponse handleStageNotification(com.thoughtworks.go.plugin.api.request.GoPluginApiRequest)>/new java.util.ArrayList/0	java.util.ArrayList	0
<com.matt_richardson.gocd.websocket_notifier.GoNotificationPlugin: com.thoughtworks.go.plugin.api.response.GoPluginApiResponse handleStageNotification(com.thoughtworks.go.plugin.api.request.GoPluginApiRequest)>/new java.util.HashMap/0	java.util.HashMap	0
<com.matt_richardson.gocd.websocket_notifier.GoNotificationPlugin: com.thoughtworks.go.plugin.api.response.GoPluginApiResponse renderJSON(int,java.lang.Object)>/new com.google.gson.GsonBuilder/0	com.google.gson.GsonBuilder	0
<com.matt_richardson.gocd.websocket_notifier.GoNotificationPlugin: com.thoughtworks.go.plugin.api.response.GoPluginApiResponse renderJSON(int,java.lang.Object)>/new com.matt_richardson.gocd.websocket_notifier.GoNotificationPlugin$1/0	com.matt_richardson.gocd.websocket_notifier.GoNotificationPlugin$1	0
<com.matt_richardson.gocd.websocket_notifier.GoNotificationPlugin: void <clinit>()>/new java.lang.String[]/0	java.lang.String[]	0
<com.matt_richardson.gocd.websocket_notifier.GoNotificationPlugin: void initializeGoApplicationAccessor(com.thoughtworks.go.plugin.api.GoApplicationAccessor)>/new com.matt_richardson.gocd.websocket_notifier.PipelineWebSocketServer/0	com.matt_richardson.gocd.websocket_notifier.PipelineWebSocketServer	10
<com.matt_richardson.gocd.websocket_notifier.GoNotificationPlugin: void initializeGoApplicationAccessor(com.thoughtworks.go.plugin.api.GoApplicationAccessor)>/new com.matt_richardson.gocd.websocket_notifier.PipelineWebSocketServer/1	com.matt_richardson.gocd.websocket_notifier.PipelineWebSocketServer	0
<com.matt_richardson.gocd.websocket_notifier.GoNotificationPlugin: void initializeGoApplicationAccessor(com.thoughtworks.go.plugin.api.GoApplicationAccessor)>/new com.matt_richardson.gocd.websocket_notifier.PluginConfig/0	com.matt_richardson.gocd.websocket_notifier.PluginConfig	10
<com.matt_richardson.gocd.websocket_notifier.GoNotificationPlugin: void initializeGoApplicationAccessor(com.thoughtworks.go.plugin.api.GoApplicationAccessor)>/new com.matt_richardson.gocd.websocket_notifier.WebSocketPipelineListener/0	com.matt_richardson.gocd.websocket_notifier.WebSocketPipelineListener	0
<com.matt_richardson.gocd.websocket_notifier.GoNotificationPlugin: void initializeGoApplicationAccessor(com.thoughtworks.go.plugin.api.GoApplicationAccessor)>/new java.lang.StringBuilder/0	java.lang.StringBuilder	0
<com.matt_richardson.gocd.websocket_notifier.GoNotificationPlugin: void initializeGoApplicationAccessor(com.thoughtworks.go.plugin.api.GoApplicationAccessor)>/new java.lang.StringBuilder/1	java.lang.StringBuilder	0
<com.matt_richardson.gocd.websocket_notifier.GoNotificationPlugin: void initializeGoApplicationAccessor(com.thoughtworks.go.plugin.api.GoApplicationAccessor)>/new java.lang.StringBuilder/2	java.lang.StringBuilder	0
<com.matt_richardson.gocd.websocket_notifier.PipelineDetailsPopulator: com.google.gson.JsonElement downloadPipelineInstanceDetails(java.lang.String)>/new com.google.gson.JsonParser/0	com.google.gson.JsonParser	10
<com.matt_richardson.gocd.websocket_notifier.PipelineDetailsPopulator: com.google.gson.JsonElement downloadPipelineInstanceDetails(java.lang.String)>/new java.io.InputStreamReader/0	java.io.InputStreamReader	10
<com.matt_richardson.gocd.websocket_notifier.PipelineDetailsPopulator: com.google.gson.JsonElement downloadPipelineInstanceDetails(java.lang.String)>/new java.lang.String/0	java.lang.String	10
<com.matt_richardson.gocd.websocket_notifier.PipelineDetailsPopulator: com.google.gson.JsonElement downloadPipelineInstanceDetails(java.lang.String)>/new java.lang.StringBuilder/0	java.lang.StringBuilder	0
<com.matt_richardson.gocd.websocket_notifier.PipelineDetailsPopulator: com.google.gson.JsonElement downloadPipelineInstanceDetails(java.lang.String)>/new java.lang.StringBuilder/1	java.lang.StringBuilder	10
<com.matt_richardson.gocd.websocket_notifier.PipelineDetailsPopulator: com.google.gson.JsonElement downloadPipelineInstanceDetails(java.lang.String)>/new java.lang.StringBuilder/2	java.lang.StringBuilder	10
<com.matt_richardson.gocd.websocket_notifier.PipelineDetailsPopulator: com.google.gson.JsonElement downloadPipelineInstanceDetails(java.lang.String)>/new java.net.URL/0	java.net.URL	10
<com.matt_richardson.gocd.websocket_notifier.PipelineDetailsPopulator: java.lang.String extendMessageToIncludePipelineDetails(java.lang.String)>/new com.google.gson.JsonParser/0	com.google.gson.JsonParser	10
<com.matt_richardson.gocd.websocket_notifier.PipelineDetailsPopulator: java.lang.String extendMessageToIncludePipelineDetails(java.lang.String)>/new java.lang.StringBuilder/0	java.lang.StringBuilder	0
<com.matt_richardson.gocd.websocket_notifier.PipelineWebSocketServer: void <init>(int)>/new java.net.InetSocketAddress/0	java.net.InetSocketAddress	0
<com.matt_richardson.gocd.websocket_notifier.PipelineWebSocketServer: void <init>(java.lang.String,int)>/new java.net.InetSocketAddress/0	java.net.InetSocketAddress	10
<com.matt_richardson.gocd.websocket_notifier.PipelineWebSocketServer: void onClose(org.java_websocket.WebSocket,int,java.lang.String,boolean)>/new java.lang.StringBuilder/0	java.lang.StringBuilder	0
<com.matt_richardson.gocd.websocket_notifier.PipelineWebSocketServer: void onOpen(org.java_websocket.WebSocket,org.java_websocket.handshake.ClientHandshake)>/new java.lang.StringBuilder/0	java.lang.StringBuilder	0
<com.matt_richardson.gocd.websocket_notifier.PipelineWebSocketServer: void sendToAll(java.lang.String)>/new java.lang.StringBuilder/0	java.lang.StringBuilder	0
<com.matt_richardson.gocd.websocket_notifier.PluginConfig: void <init>()>/new java.io.File/0	java.io.File	10
<com.matt_richardson.gocd.websocket_notifier.PluginConfig: void <init>()>/new java.lang.Object[]/0	java.lang.Object[]	10
<com.matt_richardson.gocd.websocket_notifier.PluginConfig: void <init>()>/new java.lang.StringBuilder/0	java.lang.StringBuilder	0
<com.matt_richardson.gocd.websocket_notifier.WebSocketPipelineListener: void <init>(com.matt_richardson.gocd.websocket_notifier.PipelineWebSocketServer,com.matt_richardson.gocd.websocket_notifier.PluginConfig)>/new com.matt_richardson.gocd.websocket_notifier.PipelineDetailsPopulator/0	com.matt_richardson.gocd.websocket_notifier.PipelineDetailsPopulator	10
<com.matt_richardson.gocd.websocket_notifier.WebSocketPipelineListener: void notify(com.thoughtworks.go.plugin.api.request.GoPluginApiRequest)>/new java.lang.StringBuilder/0	java.lang.StringBuilder	0
