<com.matt_richardson.gocd.websocket_notifier.GoNotificationPlugin: com.thoughtworks.go.plugin.api.response.GoPluginApiResponse handleStageNotification(com.thoughtworks.go.plugin.api.request.GoPluginApiRequest)>/phi-assign/0	<com.matt_richardson.gocd.websocket_notifier.GoNotificationPlugin: com.thoughtworks.go.plugin.api.response.GoPluginApiResponse handleStageNotification(com.thoughtworks.go.plugin.api.request.GoPluginApiRequest)>/responseCode#_78
<com.matt_richardson.gocd.websocket_notifier.GoNotificationPlugin: com.thoughtworks.go.plugin.api.response.GoPluginApiResponse handleStageNotification(com.thoughtworks.go.plugin.api.request.GoPluginApiRequest)>/phi-assign/1	<com.matt_richardson.gocd.websocket_notifier.GoNotificationPlugin: com.thoughtworks.go.plugin.api.response.GoPluginApiResponse handleStageNotification(com.thoughtworks.go.plugin.api.request.GoPluginApiRequest)>/responseCode_$$A_1#_87
<com.matt_richardson.gocd.websocket_notifier.PipelineWebSocketServer: void onOpen(org.java_websocket.WebSocket,org.java_websocket.handshake.ClientHandshake)>/assign/0	<com.matt_richardson.gocd.websocket_notifier.PipelineWebSocketServer: void onOpen(org.java_websocket.WebSocket,org.java_websocket.handshake.ClientHandshake)>/@this
<com.matt_richardson.gocd.websocket_notifier.GoNotificationPlugin$1: int responseCode()>/assign/0	<com.matt_richardson.gocd.websocket_notifier.GoNotificationPlugin$1: int responseCode()>/@this
<com.matt_richardson.gocd.websocket_notifier.GoNotificationPlugin$1: java.lang.String responseBody()>/assign/0	<com.matt_richardson.gocd.websocket_notifier.GoNotificationPlugin$1: java.lang.String responseBody()>/@this
<com.matt_richardson.gocd.websocket_notifier.GoNotificationPlugin$1: java.util.Map responseHeaders()>/assign/0	<com.matt_richardson.gocd.websocket_notifier.GoNotificationPlugin$1: java.util.Map responseHeaders()>/@this
<com.matt_richardson.gocd.websocket_notifier.GoNotificationPlugin$1: void <init>(com.matt_richardson.gocd.websocket_notifier.GoNotificationPlugin,int,java.lang.String)>/assign/0	<com.matt_richardson.gocd.websocket_notifier.GoNotificationPlugin$1: void <init>(com.matt_richardson.gocd.websocket_notifier.GoNotificationPlugin,int,java.lang.String)>/@this
<com.matt_richardson.gocd.websocket_notifier.GoNotificationPlugin$1: void <init>(com.matt_richardson.gocd.websocket_notifier.GoNotificationPlugin,int,java.lang.String)>/assign/1	<com.matt_richardson.gocd.websocket_notifier.GoNotificationPlugin$1: void <init>(com.matt_richardson.gocd.websocket_notifier.GoNotificationPlugin,int,java.lang.String)>/@parameter0
<com.matt_richardson.gocd.websocket_notifier.GoNotificationPlugin$1: void <init>(com.matt_richardson.gocd.websocket_notifier.GoNotificationPlugin,int,java.lang.String)>/assign/2	<com.matt_richardson.gocd.websocket_notifier.GoNotificationPlugin$1: void <init>(com.matt_richardson.gocd.websocket_notifier.GoNotificationPlugin,int,java.lang.String)>/@parameter1
<com.matt_richardson.gocd.websocket_notifier.GoNotificationPlugin$1: void <init>(com.matt_richardson.gocd.websocket_notifier.GoNotificationPlugin,int,java.lang.String)>/assign/3	<com.matt_richardson.gocd.websocket_notifier.GoNotificationPlugin$1: void <init>(com.matt_richardson.gocd.websocket_notifier.GoNotificationPlugin,int,java.lang.String)>/@parameter2
<com.matt_richardson.gocd.websocket_notifier.GoNotificationPlugin: com.thoughtworks.go.plugin.api.GoPluginIdentifier pluginIdentifier()>/assign/0	<com.matt_richardson.gocd.websocket_notifier.GoNotificationPlugin: com.thoughtworks.go.plugin.api.GoPluginIdentifier pluginIdentifier()>/@this
<com.matt_richardson.gocd.websocket_notifier.GoNotificationPlugin: com.thoughtworks.go.plugin.api.response.GoPluginApiResponse handle(com.thoughtworks.go.plugin.api.request.GoPluginApiRequest)>/assign/0	<com.matt_richardson.gocd.websocket_notifier.GoNotificationPlugin: com.thoughtworks.go.plugin.api.response.GoPluginApiResponse handle(com.thoughtworks.go.plugin.api.request.GoPluginApiRequest)>/@this
<com.matt_richardson.gocd.websocket_notifier.GoNotificationPlugin: com.thoughtworks.go.plugin.api.response.GoPluginApiResponse handle(com.thoughtworks.go.plugin.api.request.GoPluginApiRequest)>/assign/1	<com.matt_richardson.gocd.websocket_notifier.GoNotificationPlugin: com.thoughtworks.go.plugin.api.response.GoPluginApiResponse handle(com.thoughtworks.go.plugin.api.request.GoPluginApiRequest)>/@parameter0
<com.matt_richardson.gocd.websocket_notifier.GoNotificationPlugin: com.thoughtworks.go.plugin.api.response.GoPluginApiResponse handleNotificationsInterestedIn()>/assign/0	<com.matt_richardson.gocd.websocket_notifier.GoNotificationPlugin: com.thoughtworks.go.plugin.api.response.GoPluginApiResponse handleNotificationsInterestedIn()>/@this
<com.matt_richardson.gocd.websocket_notifier.GoNotificationPlugin: com.thoughtworks.go.plugin.api.response.GoPluginApiResponse handleStageNotification(com.thoughtworks.go.plugin.api.request.GoPluginApiRequest)>/assign/0	<com.matt_richardson.gocd.websocket_notifier.GoNotificationPlugin: com.thoughtworks.go.plugin.api.response.GoPluginApiResponse handleStageNotification(com.thoughtworks.go.plugin.api.request.GoPluginApiRequest)>/@this
<com.matt_richardson.gocd.websocket_notifier.GoNotificationPlugin: com.thoughtworks.go.plugin.api.response.GoPluginApiResponse handleStageNotification(com.thoughtworks.go.plugin.api.request.GoPluginApiRequest)>/assign/1	<com.matt_richardson.gocd.websocket_notifier.GoNotificationPlugin: com.thoughtworks.go.plugin.api.response.GoPluginApiResponse handleStageNotification(com.thoughtworks.go.plugin.api.request.GoPluginApiRequest)>/@parameter0
<com.matt_richardson.gocd.websocket_notifier.GoNotificationPlugin: com.thoughtworks.go.plugin.api.response.GoPluginApiResponse renderJSON(int,java.lang.Object)>/assign/0	<com.matt_richardson.gocd.websocket_notifier.GoNotificationPlugin: com.thoughtworks.go.plugin.api.response.GoPluginApiResponse renderJSON(int,java.lang.Object)>/@this
<com.matt_richardson.gocd.websocket_notifier.GoNotificationPlugin: com.thoughtworks.go.plugin.api.response.GoPluginApiResponse renderJSON(int,java.lang.Object)>/assign/1	<com.matt_richardson.gocd.websocket_notifier.GoNotificationPlugin: com.thoughtworks.go.plugin.api.response.GoPluginApiResponse renderJSON(int,java.lang.Object)>/@parameter0
<com.matt_richardson.gocd.websocket_notifier.GoNotificationPlugin: com.thoughtworks.go.plugin.api.response.GoPluginApiResponse renderJSON(int,java.lang.Object)>/assign/2	<com.matt_richardson.gocd.websocket_notifier.GoNotificationPlugin: com.thoughtworks.go.plugin.api.response.GoPluginApiResponse renderJSON(int,java.lang.Object)>/@parameter1
<com.matt_richardson.gocd.websocket_notifier.GoNotificationPlugin: com.thoughtworks.go.plugin.api.response.GoPluginApiResponse renderJSON(int,java.lang.Object)>/phi-assign/0	<com.matt_richardson.gocd.websocket_notifier.GoNotificationPlugin: com.thoughtworks.go.plugin.api.response.GoPluginApiResponse renderJSON(int,java.lang.Object)>/$stack7
<com.matt_richardson.gocd.websocket_notifier.GoNotificationPlugin: com.thoughtworks.go.plugin.api.response.GoPluginApiResponse renderJSON(int,java.lang.Object)>/phi-assign/1	<com.matt_richardson.gocd.websocket_notifier.GoNotificationPlugin: com.thoughtworks.go.plugin.api.response.GoPluginApiResponse renderJSON(int,java.lang.Object)>/$stack7_$$A_1
<com.matt_richardson.gocd.websocket_notifier.GoNotificationPlugin: void <init>()>/assign/0	<com.matt_richardson.gocd.websocket_notifier.GoNotificationPlugin: void <init>()>/@this
<com.matt_richardson.gocd.websocket_notifier.GoNotificationPlugin: void initializeGoApplicationAccessor(com.thoughtworks.go.plugin.api.GoApplicationAccessor)>/assign/0	<com.matt_richardson.gocd.websocket_notifier.GoNotificationPlugin: void initializeGoApplicationAccessor(com.thoughtworks.go.plugin.api.GoApplicationAccessor)>/@this
<com.matt_richardson.gocd.websocket_notifier.GoNotificationPlugin: void initializeGoApplicationAccessor(com.thoughtworks.go.plugin.api.GoApplicationAccessor)>/assign/1	<com.matt_richardson.gocd.websocket_notifier.GoNotificationPlugin: void initializeGoApplicationAccessor(com.thoughtworks.go.plugin.api.GoApplicationAccessor)>/@parameter0
<com.matt_richardson.gocd.websocket_notifier.PipelineWebSocketServer: void <init>(int)>/assign/0	<com.matt_richardson.gocd.websocket_notifier.PipelineWebSocketServer: void <init>(int)>/@this
<com.matt_richardson.gocd.websocket_notifier.PipelineWebSocketServer: void <init>(int)>/assign/1	<com.matt_richardson.gocd.websocket_notifier.PipelineWebSocketServer: void <init>(int)>/@parameter0
<com.matt_richardson.gocd.websocket_notifier.PipelineWebSocketServer: void onOpen(org.java_websocket.WebSocket,org.java_websocket.handshake.ClientHandshake)>/assign/1	<com.matt_richardson.gocd.websocket_notifier.PipelineWebSocketServer: void onOpen(org.java_websocket.WebSocket,org.java_websocket.handshake.ClientHandshake)>/@parameter0
<com.matt_richardson.gocd.websocket_notifier.PipelineWebSocketServer: void onOpen(org.java_websocket.WebSocket,org.java_websocket.handshake.ClientHandshake)>/assign/2	<com.matt_richardson.gocd.websocket_notifier.PipelineWebSocketServer: void onOpen(org.java_websocket.WebSocket,org.java_websocket.handshake.ClientHandshake)>/@parameter1
<com.matt_richardson.gocd.websocket_notifier.PipelineWebSocketServer: void onClose(org.java_websocket.WebSocket,int,java.lang.String,boolean)>/assign/0	<com.matt_richardson.gocd.websocket_notifier.PipelineWebSocketServer: void onClose(org.java_websocket.WebSocket,int,java.lang.String,boolean)>/@this
<com.matt_richardson.gocd.websocket_notifier.PipelineWebSocketServer: void onClose(org.java_websocket.WebSocket,int,java.lang.String,boolean)>/assign/1	<com.matt_richardson.gocd.websocket_notifier.PipelineWebSocketServer: void onClose(org.java_websocket.WebSocket,int,java.lang.String,boolean)>/@parameter0
<com.matt_richardson.gocd.websocket_notifier.PipelineWebSocketServer: void onClose(org.java_websocket.WebSocket,int,java.lang.String,boolean)>/assign/2	<com.matt_richardson.gocd.websocket_notifier.PipelineWebSocketServer: void onClose(org.java_websocket.WebSocket,int,java.lang.String,boolean)>/@parameter1
<com.matt_richardson.gocd.websocket_notifier.PipelineWebSocketServer: void onClose(org.java_websocket.WebSocket,int,java.lang.String,boolean)>/assign/3	<com.matt_richardson.gocd.websocket_notifier.PipelineWebSocketServer: void onClose(org.java_websocket.WebSocket,int,java.lang.String,boolean)>/@parameter2
<com.matt_richardson.gocd.websocket_notifier.PipelineWebSocketServer: void onClose(org.java_websocket.WebSocket,int,java.lang.String,boolean)>/assign/4	<com.matt_richardson.gocd.websocket_notifier.PipelineWebSocketServer: void onClose(org.java_websocket.WebSocket,int,java.lang.String,boolean)>/@parameter3
<com.matt_richardson.gocd.websocket_notifier.PipelineWebSocketServer: void onError(org.java_websocket.WebSocket,java.lang.Exception)>/assign/0	<com.matt_richardson.gocd.websocket_notifier.PipelineWebSocketServer: void onError(org.java_websocket.WebSocket,java.lang.Exception)>/@this
<com.matt_richardson.gocd.websocket_notifier.PipelineWebSocketServer: void onError(org.java_websocket.WebSocket,java.lang.Exception)>/assign/1	<com.matt_richardson.gocd.websocket_notifier.PipelineWebSocketServer: void onError(org.java_websocket.WebSocket,java.lang.Exception)>/@parameter0
<com.matt_richardson.gocd.websocket_notifier.PipelineWebSocketServer: void onError(org.java_websocket.WebSocket,java.lang.Exception)>/assign/2	<com.matt_richardson.gocd.websocket_notifier.PipelineWebSocketServer: void onError(org.java_websocket.WebSocket,java.lang.Exception)>/@parameter1
<com.matt_richardson.gocd.websocket_notifier.PipelineWebSocketServer: void onMessage(org.java_websocket.WebSocket,java.lang.String)>/assign/0	<com.matt_richardson.gocd.websocket_notifier.PipelineWebSocketServer: void onMessage(org.java_websocket.WebSocket,java.lang.String)>/@this
<com.matt_richardson.gocd.websocket_notifier.PipelineWebSocketServer: void onMessage(org.java_websocket.WebSocket,java.lang.String)>/assign/1	<com.matt_richardson.gocd.websocket_notifier.PipelineWebSocketServer: void onMessage(org.java_websocket.WebSocket,java.lang.String)>/@parameter0
<com.matt_richardson.gocd.websocket_notifier.PipelineWebSocketServer: void onMessage(org.java_websocket.WebSocket,java.lang.String)>/assign/2	<com.matt_richardson.gocd.websocket_notifier.PipelineWebSocketServer: void onMessage(org.java_websocket.WebSocket,java.lang.String)>/@parameter1
<com.matt_richardson.gocd.websocket_notifier.PipelineWebSocketServer: void sendToAll(java.lang.String)>/assign/0	<com.matt_richardson.gocd.websocket_notifier.PipelineWebSocketServer: void sendToAll(java.lang.String)>/@this
<com.matt_richardson.gocd.websocket_notifier.PipelineWebSocketServer: void sendToAll(java.lang.String)>/assign/1	<com.matt_richardson.gocd.websocket_notifier.PipelineWebSocketServer: void sendToAll(java.lang.String)>/@parameter0
<com.matt_richardson.gocd.websocket_notifier.WebSocketPipelineListener: void <init>(com.matt_richardson.gocd.websocket_notifier.PipelineWebSocketServer)>/assign/0	<com.matt_richardson.gocd.websocket_notifier.WebSocketPipelineListener: void <init>(com.matt_richardson.gocd.websocket_notifier.PipelineWebSocketServer)>/@this
<com.matt_richardson.gocd.websocket_notifier.WebSocketPipelineListener: void <init>(com.matt_richardson.gocd.websocket_notifier.PipelineWebSocketServer)>/assign/1	<com.matt_richardson.gocd.websocket_notifier.WebSocketPipelineListener: void <init>(com.matt_richardson.gocd.websocket_notifier.PipelineWebSocketServer)>/@parameter0
<com.matt_richardson.gocd.websocket_notifier.WebSocketPipelineListener: void notify(com.thoughtworks.go.plugin.api.request.GoPluginApiRequest)>/assign/0	<com.matt_richardson.gocd.websocket_notifier.WebSocketPipelineListener: void notify(com.thoughtworks.go.plugin.api.request.GoPluginApiRequest)>/@this
<com.matt_richardson.gocd.websocket_notifier.WebSocketPipelineListener: void notify(com.thoughtworks.go.plugin.api.request.GoPluginApiRequest)>/assign/1	<com.matt_richardson.gocd.websocket_notifier.WebSocketPipelineListener: void notify(com.thoughtworks.go.plugin.api.request.GoPluginApiRequest)>/@parameter0
