<simplejavacalculator.Calculator$BiOperatorModes: simplejavacalculator.Calculator$BiOperatorModes valueOf(java.lang.String)>/@parameter0	<simplejavacalculator.Calculator$BiOperatorModes: simplejavacalculator.Calculator$BiOperatorModes valueOf(java.lang.String)>/name#_0	<simplejavacalculator.Calculator$BiOperatorModes: simplejavacalculator.Calculator$BiOperatorModes valueOf(java.lang.String)>
<simplejavacalculator.Calculator$BiOperatorModes: void <init>(java.lang.String,int)>/@this	<simplejavacalculator.Calculator$BiOperatorModes: void <init>(java.lang.String,int)>/this#_0	<simplejavacalculator.Calculator$BiOperatorModes: void <init>(java.lang.String,int)>
<simplejavacalculator.Calculator$BiOperatorModes: void <init>(java.lang.String,int)>/@parameter0	<simplejavacalculator.Calculator$BiOperatorModes: void <init>(java.lang.String,int)>/l1#_0	<simplejavacalculator.Calculator$BiOperatorModes: void <init>(java.lang.String,int)>
<simplejavacalculator.Calculator$BiOperatorModes: void <init>(java.lang.String,int)>/@parameter1	<simplejavacalculator.Calculator$BiOperatorModes: void <init>(java.lang.String,int)>/l2#_0	<simplejavacalculator.Calculator$BiOperatorModes: void <init>(java.lang.String,int)>
<simplejavacalculator.BufferedImageCustom: void <init>()>/@this	<simplejavacalculator.BufferedImageCustom: void <init>()>/this#_0	<simplejavacalculator.BufferedImageCustom: void <init>()>
<simplejavacalculator.BufferedImageCustom: java.awt.Image imageReturn()>/@this	<simplejavacalculator.BufferedImageCustom: java.awt.Image imageReturn()>/this#_0	<simplejavacalculator.BufferedImageCustom: java.awt.Image imageReturn()>
<simplejavacalculator.SimpleJavaCalculator: void <init>()>/@this	<simplejavacalculator.SimpleJavaCalculator: void <init>()>/this#_0	<simplejavacalculator.SimpleJavaCalculator: void <init>()>
<simplejavacalculator.SimpleJavaCalculator: void main(java.lang.String[])>/@parameter0	<simplejavacalculator.SimpleJavaCalculator: void main(java.lang.String[])>/args#_0	<simplejavacalculator.SimpleJavaCalculator: void main(java.lang.String[])>
<simplejavacalculator.Calculator$MonoOperatorModes: simplejavacalculator.Calculator$MonoOperatorModes valueOf(java.lang.String)>/@parameter0	<simplejavacalculator.Calculator$MonoOperatorModes: simplejavacalculator.Calculator$MonoOperatorModes valueOf(java.lang.String)>/name#_0	<simplejavacalculator.Calculator$MonoOperatorModes: simplejavacalculator.Calculator$MonoOperatorModes valueOf(java.lang.String)>
<simplejavacalculator.Calculator$MonoOperatorModes: void <init>(java.lang.String,int)>/@this	<simplejavacalculator.Calculator$MonoOperatorModes: void <init>(java.lang.String,int)>/this#_0	<simplejavacalculator.Calculator$MonoOperatorModes: void <init>(java.lang.String,int)>
<simplejavacalculator.Calculator$MonoOperatorModes: void <init>(java.lang.String,int)>/@parameter0	<simplejavacalculator.Calculator$MonoOperatorModes: void <init>(java.lang.String,int)>/l1#_0	<simplejavacalculator.Calculator$MonoOperatorModes: void <init>(java.lang.String,int)>
<simplejavacalculator.Calculator$MonoOperatorModes: void <init>(java.lang.String,int)>/@parameter1	<simplejavacalculator.Calculator$MonoOperatorModes: void <init>(java.lang.String,int)>/l2#_0	<simplejavacalculator.Calculator$MonoOperatorModes: void <init>(java.lang.String,int)>
<simplejavacalculator.UI: void <init>()>/@this	<simplejavacalculator.UI: void <init>()>/this#_0	<simplejavacalculator.UI: void <init>()>
<simplejavacalculator.UI: void <init>()>/i#_89	<simplejavacalculator.UI: void <init>()>/i_$$A_1#_90	<simplejavacalculator.UI: void <init>()>
<simplejavacalculator.UI: void <init>()>/i_$$A_2#_89	<simplejavacalculator.UI: void <init>()>/i_$$A_1#_90	<simplejavacalculator.UI: void <init>()>
<simplejavacalculator.UI: void init()>/@this	<simplejavacalculator.UI: void init()>/this#_0	<simplejavacalculator.UI: void init()>
<simplejavacalculator.UI: void init()>/i#_126	<simplejavacalculator.UI: void init()>/i_$$A_1#_127	<simplejavacalculator.UI: void init()>
<simplejavacalculator.UI: void init()>/i_$$A_2#_126	<simplejavacalculator.UI: void init()>/i_$$A_1#_127	<simplejavacalculator.UI: void init()>
<simplejavacalculator.UI: void init()>/i_$$A_3#_197	<simplejavacalculator.UI: void init()>/i_$$A_4#_198	<simplejavacalculator.UI: void init()>
<simplejavacalculator.UI: void init()>/i_$$A_5#_197	<simplejavacalculator.UI: void init()>/i_$$A_4#_198	<simplejavacalculator.UI: void init()>
<simplejavacalculator.UI: void actionPerformed(java.awt.event.ActionEvent)>/@this	<simplejavacalculator.UI: void actionPerformed(java.awt.event.ActionEvent)>/this#_0	<simplejavacalculator.UI: void actionPerformed(java.awt.event.ActionEvent)>
<simplejavacalculator.UI: void actionPerformed(java.awt.event.ActionEvent)>/@parameter0	<simplejavacalculator.UI: void actionPerformed(java.awt.event.ActionEvent)>/e#_0	<simplejavacalculator.UI: void actionPerformed(java.awt.event.ActionEvent)>
<simplejavacalculator.UI: void actionPerformed(java.awt.event.ActionEvent)>/i#_226	<simplejavacalculator.UI: void actionPerformed(java.awt.event.ActionEvent)>/i_$$A_1#_227	<simplejavacalculator.UI: void actionPerformed(java.awt.event.ActionEvent)>
<simplejavacalculator.UI: void actionPerformed(java.awt.event.ActionEvent)>/i_$$A_2#_226	<simplejavacalculator.UI: void actionPerformed(java.awt.event.ActionEvent)>/i_$$A_1#_227	<simplejavacalculator.UI: void actionPerformed(java.awt.event.ActionEvent)>
<simplejavacalculator.UI: void parsetoBinary()>/@this	<simplejavacalculator.UI: void parsetoBinary()>/this#_0	<simplejavacalculator.UI: void parsetoBinary()>
<simplejavacalculator.UI: java.lang.Double reader()>/@this	<simplejavacalculator.UI: java.lang.Double reader()>/this#_0	<simplejavacalculator.UI: java.lang.Double reader()>
<simplejavacalculator.UI: void writer(java.lang.Double)>/@this	<simplejavacalculator.UI: void writer(java.lang.Double)>/this#_0	<simplejavacalculator.UI: void writer(java.lang.Double)>
<simplejavacalculator.UI: void writer(java.lang.Double)>/@parameter0	<simplejavacalculator.UI: void writer(java.lang.Double)>/num#_0	<simplejavacalculator.UI: void writer(java.lang.Double)>
<simplejavacalculator.Calculator: void <init>()>/@this	<simplejavacalculator.Calculator: void <init>()>/this#_0	<simplejavacalculator.Calculator: void <init>()>
<simplejavacalculator.Calculator: java.lang.Double calculateBiImpl()>/@this	<simplejavacalculator.Calculator: java.lang.Double calculateBiImpl()>/this#_0	<simplejavacalculator.Calculator: java.lang.Double calculateBiImpl()>
<simplejavacalculator.Calculator: java.lang.Double calculateBi(simplejavacalculator.Calculator$BiOperatorModes,java.lang.Double)>/@this	<simplejavacalculator.Calculator: java.lang.Double calculateBi(simplejavacalculator.Calculator$BiOperatorModes,java.lang.Double)>/this#_0	<simplejavacalculator.Calculator: java.lang.Double calculateBi(simplejavacalculator.Calculator$BiOperatorModes,java.lang.Double)>
<simplejavacalculator.Calculator: java.lang.Double calculateBi(simplejavacalculator.Calculator$BiOperatorModes,java.lang.Double)>/@parameter0	<simplejavacalculator.Calculator: java.lang.Double calculateBi(simplejavacalculator.Calculator$BiOperatorModes,java.lang.Double)>/newMode#_0	<simplejavacalculator.Calculator: java.lang.Double calculateBi(simplejavacalculator.Calculator$BiOperatorModes,java.lang.Double)>
<simplejavacalculator.Calculator: java.lang.Double calculateBi(simplejavacalculator.Calculator$BiOperatorModes,java.lang.Double)>/@parameter1	<simplejavacalculator.Calculator: java.lang.Double calculateBi(simplejavacalculator.Calculator$BiOperatorModes,java.lang.Double)>/num#_0	<simplejavacalculator.Calculator: java.lang.Double calculateBi(simplejavacalculator.Calculator$BiOperatorModes,java.lang.Double)>
<simplejavacalculator.Calculator: java.lang.Double calculateEqual(java.lang.Double)>/@this	<simplejavacalculator.Calculator: java.lang.Double calculateEqual(java.lang.Double)>/this#_0	<simplejavacalculator.Calculator: java.lang.Double calculateEqual(java.lang.Double)>
<simplejavacalculator.Calculator: java.lang.Double calculateEqual(java.lang.Double)>/@parameter0	<simplejavacalculator.Calculator: java.lang.Double calculateEqual(java.lang.Double)>/num#_0	<simplejavacalculator.Calculator: java.lang.Double calculateEqual(java.lang.Double)>
<simplejavacalculator.Calculator: java.lang.Double reset()>/@this	<simplejavacalculator.Calculator: java.lang.Double reset()>/this#_0	<simplejavacalculator.Calculator: java.lang.Double reset()>
<simplejavacalculator.Calculator: java.lang.Double calculateMono(simplejavacalculator.Calculator$MonoOperatorModes,java.lang.Double)>/@this	<simplejavacalculator.Calculator: java.lang.Double calculateMono(simplejavacalculator.Calculator$MonoOperatorModes,java.lang.Double)>/this#_0	<simplejavacalculator.Calculator: java.lang.Double calculateMono(simplejavacalculator.Calculator$MonoOperatorModes,java.lang.Double)>
<simplejavacalculator.Calculator: java.lang.Double calculateMono(simplejavacalculator.Calculator$MonoOperatorModes,java.lang.Double)>/@parameter0	<simplejavacalculator.Calculator: java.lang.Double calculateMono(simplejavacalculator.Calculator$MonoOperatorModes,java.lang.Double)>/newMode#_0	<simplejavacalculator.Calculator: java.lang.Double calculateMono(simplejavacalculator.Calculator$MonoOperatorModes,java.lang.Double)>
<simplejavacalculator.Calculator: java.lang.Double calculateMono(simplejavacalculator.Calculator$MonoOperatorModes,java.lang.Double)>/@parameter1	<simplejavacalculator.Calculator: java.lang.Double calculateMono(simplejavacalculator.Calculator$MonoOperatorModes,java.lang.Double)>/num#_0	<simplejavacalculator.Calculator: java.lang.Double calculateMono(simplejavacalculator.Calculator$MonoOperatorModes,java.lang.Double)>
