java.lang.Object	simplejavacalculator.SimpleJavaCalculator
java.lang.Object	simplejavacalculator.UI
java.lang.Object	simplejavacalculator.Calculator
java.lang.Object	simplejavacalculator.BufferedImageCustom
simplejavacalculator.Calculator$BiOperatorModes	simplejavacalculator.Calculator$BiOperatorModes
simplejavacalculator.SimpleJavaCalculator	simplejavacalculator.SimpleJavaCalculator
simplejavacalculator.Calculator$MonoOperatorModes	simplejavacalculator.Calculator$MonoOperatorModes
simplejavacalculator.UI	simplejavacalculator.UI
simplejavacalculator.Calculator	simplejavacalculator.Calculator
simplejavacalculator.BufferedImageCustom	simplejavacalculator.BufferedImageCustom
simplejavacalculator.Calculator$BiOperatorModes[]	simplejavacalculator.Calculator$BiOperatorModes[]
java.lang.String[]	java.lang.String[]
simplejavacalculator.Calculator$MonoOperatorModes[]	simplejavacalculator.Calculator$MonoOperatorModes[]
javax.swing.JButton[]	javax.swing.JButton[]
javax.swing.JFrame	javax.swing.JFrame
javax.swing.ImageIcon	javax.swing.ImageIcon
javax.swing.JPanel	javax.swing.JPanel
javax.swing.BoxLayout	javax.swing.BoxLayout
java.awt.FlowLayout	java.awt.FlowLayout
java.awt.Font	java.awt.Font
javax.swing.JTextArea	javax.swing.JTextArea
javax.swing.JButton	javax.swing.JButton
java.lang.StringBuilder	java.lang.StringBuilder
java.lang.Error	java.lang.Error
java.lang.Enum	simplejavacalculator.Calculator$BiOperatorModes
java.lang.Enum	simplejavacalculator.Calculator$MonoOperatorModes
java.awt.event.ActionListener	simplejavacalculator.UI
