java.lang.Object	simplejavacalculator.UI	0
java.lang.Object	simplejavacalculator.SimpleJavaCalculator	0
java.lang.Object	simplejavacalculator.Calculator	0
java.lang.Object	simplejavacalculator.BufferedImageCustom	10
simplejavacalculator.Calculator$BiOperatorModes	simplejavacalculator.Calculator$BiOperatorModes	0
simplejavacalculator.Calculator$MonoOperatorModes	simplejavacalculator.Calculator$MonoOperatorModes	0
simplejavacalculator.UI	simplejavacalculator.UI	0
simplejavacalculator.SimpleJavaCalculator	simplejavacalculator.SimpleJavaCalculator	0
simplejavacalculator.Calculator	simplejavacalculator.Calculator	0
simplejavacalculator.BufferedImageCustom	simplejavacalculator.BufferedImageCustom	10
simplejavacalculator.Calculator$BiOperatorModes[]	simplejavacalculator.Calculator$BiOperatorModes[]	0
java.lang.String[]	java.lang.String[]	0
javax.swing.JButton[]	javax.swing.JButton[]	0
simplejavacalculator.Calculator$MonoOperatorModes[]	simplejavacalculator.Calculator$MonoOperatorModes[]	0
java.lang.StringBuilder	java.lang.StringBuilder	0
javax.swing.JButton	javax.swing.JButton	0
javax.swing.JPanel	javax.swing.JPanel	0
java.awt.Font	java.awt.Font	0
java.awt.FlowLayout	java.awt.FlowLayout	0
javax.swing.JTextArea	javax.swing.JTextArea	0
javax.swing.JFrame	javax.swing.JFrame	0
javax.swing.ImageIcon	javax.swing.ImageIcon	0
java.lang.Error	java.lang.Error	0
javax.swing.BoxLayout	javax.swing.BoxLayout	0
java.lang.Enum	simplejavacalculator.Calculator$BiOperatorModes	0
java.lang.Enum	simplejavacalculator.Calculator$MonoOperatorModes	0
java.awt.event.ActionListener	simplejavacalculator.UI	0
