<simplejavacalculator.UI: void actionPerformed(java.awt.event.ActionEvent)>/assign/0	<simplejavacalculator.UI: void actionPerformed(java.awt.event.ActionEvent)>/@this	0
<simplejavacalculator.Calculator: java.lang.Double calculateMono(simplejavacalculator.Calculator$MonoOperatorModes,java.lang.Double)>/assign/0	<simplejavacalculator.Calculator: java.lang.Double calculateMono(simplejavacalculator.Calculator$MonoOperatorModes,java.lang.Double)>/@this	0
<simplejavacalculator.Calculator: java.lang.Double calculateEqual(java.lang.Double)>/assign/0	<simplejavacalculator.Calculator: java.lang.Double calculateEqual(java.lang.Double)>/@this	0
<simplejavacalculator.UI: void init()>/phi-assign/3	<simplejavacalculator.UI: void init()>/i_$$A_5#_197	0
<simplejavacalculator.Calculator: java.lang.Double calculateBiImpl()>/assign/0	<simplejavacalculator.Calculator: java.lang.Double calculateBiImpl()>/@this	0
<simplejavacalculator.UI: void writer(java.lang.Double)>/assign/1	<simplejavacalculator.UI: void writer(java.lang.Double)>/@parameter0	0
<simplejavacalculator.UI: void init()>/phi-assign/1	<simplejavacalculator.UI: void init()>/i_$$A_2#_126	0
<simplejavacalculator.Calculator$BiOperatorModes: void <init>(java.lang.String,int)>/assign/1	<simplejavacalculator.Calculator$BiOperatorModes: void <init>(java.lang.String,int)>/@parameter0	0
<simplejavacalculator.Calculator$BiOperatorModes: void <init>(java.lang.String,int)>/assign/0	<simplejavacalculator.Calculator$BiOperatorModes: void <init>(java.lang.String,int)>/@this	0
<simplejavacalculator.Calculator$MonoOperatorModes: void <init>(java.lang.String,int)>/assign/2	<simplejavacalculator.Calculator$MonoOperatorModes: void <init>(java.lang.String,int)>/@parameter1	0
<simplejavacalculator.UI: void parsetoBinary()>/assign/0	<simplejavacalculator.UI: void parsetoBinary()>/@this	0
<simplejavacalculator.Calculator$BiOperatorModes: simplejavacalculator.Calculator$BiOperatorModes valueOf(java.lang.String)>/assign/0	<simplejavacalculator.Calculator$BiOperatorModes: simplejavacalculator.Calculator$BiOperatorModes valueOf(java.lang.String)>/@parameter0	0
<simplejavacalculator.UI: void init()>/assign/0	<simplejavacalculator.UI: void init()>/@this	0
<simplejavacalculator.Calculator$MonoOperatorModes: void <init>(java.lang.String,int)>/assign/1	<simplejavacalculator.Calculator$MonoOperatorModes: void <init>(java.lang.String,int)>/@parameter0	0
<simplejavacalculator.Calculator: void <init>()>/assign/0	<simplejavacalculator.Calculator: void <init>()>/@this	0
<simplejavacalculator.Calculator: java.lang.Double reset()>/assign/0	<simplejavacalculator.Calculator: java.lang.Double reset()>/@this	0
<simplejavacalculator.Calculator: java.lang.Double calculateEqual(java.lang.Double)>/assign/1	<simplejavacalculator.Calculator: java.lang.Double calculateEqual(java.lang.Double)>/@parameter0	0
<simplejavacalculator.Calculator: java.lang.Double calculateMono(simplejavacalculator.Calculator$MonoOperatorModes,java.lang.Double)>/assign/1	<simplejavacalculator.Calculator: java.lang.Double calculateMono(simplejavacalculator.Calculator$MonoOperatorModes,java.lang.Double)>/@parameter0	0
<simplejavacalculator.Calculator$MonoOperatorModes: void <init>(java.lang.String,int)>/assign/0	<simplejavacalculator.Calculator$MonoOperatorModes: void <init>(java.lang.String,int)>/@this	0
<simplejavacalculator.UI: void actionPerformed(java.awt.event.ActionEvent)>/phi-assign/0	<simplejavacalculator.UI: void actionPerformed(java.awt.event.ActionEvent)>/i#_226	0
<simplejavacalculator.UI: void actionPerformed(java.awt.event.ActionEvent)>/assign/1	<simplejavacalculator.UI: void actionPerformed(java.awt.event.ActionEvent)>/@parameter0	0
<simplejavacalculator.UI: void init()>/phi-assign/0	<simplejavacalculator.UI: void init()>/i#_126	0
<simplejavacalculator.Calculator$MonoOperatorModes: simplejavacalculator.Calculator$MonoOperatorModes valueOf(java.lang.String)>/assign/0	<simplejavacalculator.Calculator$MonoOperatorModes: simplejavacalculator.Calculator$MonoOperatorModes valueOf(java.lang.String)>/@parameter0	0
<simplejavacalculator.UI: void <init>()>/assign/0	<simplejavacalculator.UI: void <init>()>/@this	0
<simplejavacalculator.Calculator$BiOperatorModes: void <init>(java.lang.String,int)>/assign/2	<simplejavacalculator.Calculator$BiOperatorModes: void <init>(java.lang.String,int)>/@parameter1	0
<simplejavacalculator.Calculator: java.lang.Double calculateBi(simplejavacalculator.Calculator$BiOperatorModes,java.lang.Double)>/assign/2	<simplejavacalculator.Calculator: java.lang.Double calculateBi(simplejavacalculator.Calculator$BiOperatorModes,java.lang.Double)>/@parameter1	0
<simplejavacalculator.SimpleJavaCalculator: void <init>()>/assign/0	<simplejavacalculator.SimpleJavaCalculator: void <init>()>/@this	0
<simplejavacalculator.Calculator: java.lang.Double calculateBi(simplejavacalculator.Calculator$BiOperatorModes,java.lang.Double)>/assign/1	<simplejavacalculator.Calculator: java.lang.Double calculateBi(simplejavacalculator.Calculator$BiOperatorModes,java.lang.Double)>/@parameter0	0
<simplejavacalculator.UI: java.lang.Double reader()>/assign/0	<simplejavacalculator.UI: java.lang.Double reader()>/@this	0
<simplejavacalculator.SimpleJavaCalculator: void main(java.lang.String[])>/assign/0	<simplejavacalculator.SimpleJavaCalculator: void main(java.lang.String[])>/@parameter0	0
<simplejavacalculator.Calculator: java.lang.Double calculateMono(simplejavacalculator.Calculator$MonoOperatorModes,java.lang.Double)>/assign/2	<simplejavacalculator.Calculator: java.lang.Double calculateMono(simplejavacalculator.Calculator$MonoOperatorModes,java.lang.Double)>/@parameter1	0
<simplejavacalculator.UI: void actionPerformed(java.awt.event.ActionEvent)>/phi-assign/1	<simplejavacalculator.UI: void actionPerformed(java.awt.event.ActionEvent)>/i_$$A_2#_226	0
<simplejavacalculator.Calculator: java.lang.Double calculateBi(simplejavacalculator.Calculator$BiOperatorModes,java.lang.Double)>/assign/0	<simplejavacalculator.Calculator: java.lang.Double calculateBi(simplejavacalculator.Calculator$BiOperatorModes,java.lang.Double)>/@this	0
<simplejavacalculator.UI: void writer(java.lang.Double)>/assign/0	<simplejavacalculator.UI: void writer(java.lang.Double)>/@this	0
<simplejavacalculator.UI: void <init>()>/phi-assign/1	<simplejavacalculator.UI: void <init>()>/i_$$A_2#_89	1
<simplejavacalculator.UI: void <init>()>/phi-assign/1	<simplejavacalculator.UI: void <init>()>/i_$$A_2#_89	10
<simplejavacalculator.UI: void <init>()>/phi-assign/0	<simplejavacalculator.UI: void <init>()>/i#_89	1
<simplejavacalculator.UI: void <init>()>/phi-assign/0	<simplejavacalculator.UI: void <init>()>/i#_89	10
<simplejavacalculator.UI: void init()>/phi-assign/2	<simplejavacalculator.UI: void init()>/i_$$A_3#_197	1
<simplejavacalculator.UI: void init()>/phi-assign/2	<simplejavacalculator.UI: void init()>/i_$$A_3#_197	10
<simplejavacalculator.BufferedImageCustom: void <init>()>/assign/0	<simplejavacalculator.BufferedImageCustom: void <init>()>/@this	10
<simplejavacalculator.BufferedImageCustom: java.awt.Image imageReturn()>/assign/0	<simplejavacalculator.BufferedImageCustom: java.awt.Image imageReturn()>/@this	10
