run.halo.app.security.authentication.jwt.JwtAuthenticationConfigurer	JwtAuthenticationConfigurer
run.halo.app.plugin.DefaultPluginRouterFunctionRegistry	DefaultPluginRouterFunctionRegistry
run.halo.app.theme.finders.vo.PostArchiveYearMonthVo	PostArchiveYearMonthVo
run.halo.app.theme.config.ThemeConfiguration	ThemeConfiguration
run.halo.app.theme.finders.vo.SiteStatsVo$SiteStatsVoBuilder	SiteStatsVo$SiteStatsVoBuilder
run.halo.app.infra.utils.VersionUtils	VersionUtils
run.halo.app.event.post.UpvotedEvent	UpvotedEvent
run.halo.app.content.SnapshotService	SnapshotService
run.halo.app.infra.properties.ThemeProperties	ThemeProperties
run.halo.app.extension.store.ExtensionStore	ExtensionStore
run.halo.app.core.extension.service.impl.EmailVerificationServiceImpl	EmailVerificationServiceImpl
run.halo.app.notification.endpoint.ConsoleNotifierEndpoint	ConsoleNotifierEndpoint
run.halo.app.config.WebServerSecurityConfig	WebServerSecurityConfig
run.halo.app.core.extension.reconciler.RoleBindingReconciler	RoleBindingReconciler
org.springframework.boot.loader.jar.NestedJarFile$RawZipDataInputStream	NestedJarFile$RawZipDataInputStream
run.halo.app.security.authorization.RuleAccumulator	RuleAccumulator
run.halo.app.infra.properties.JwtProperties	JwtProperties
org.springframework.boot.loader.net.protocol.jar.UrlJarEntry	UrlJarEntry
run.halo.app.core.extension.theme.ThemeEndpoint$ThemeQuery	ThemeEndpoint$ThemeQuery
run.halo.app.core.extension.attachment.endpoint.LocalAttachmentUploadHandler	LocalAttachmentUploadHandler
run.halo.app.endpoint.uc.content.UcSnapshotEndpoint	UcSnapshotEndpoint
run.halo.app.security.ListedAuthProvider	ListedAuthProvider
run.halo.app.infra.exception.NotFoundException	NotFoundException
run.halo.app.security.authentication.WebExchangeMatchers	WebExchangeMatchers
run.halo.app.extension.exception.ExtensionNotFoundException	ExtensionNotFoundException
run.halo.app.security.authentication.twofactor.TwoFactorAuthEndpoint	TwoFactorAuthEndpoint
run.halo.app.security.authentication.rememberme.RememberMeAuthenticationManager	RememberMeAuthenticationManager
run.halo.app.content.comment.ListedReply	ListedReply
run.halo.app.theme.finders.SiteStatsFinder	SiteStatsFinder
org.springframework.boot.loader.zip.ZipContent$Loader	ZipContent$Loader
org.springframework.boot.loader.launch.PropertiesLauncher$Instantiator$Using	PropertiesLauncher$Instantiator$Using
run.halo.app.core.extension.service.impl.EmailPasswordRecoveryServiceImpl$ResetPasswordVerificationManager$Verification	EmailPasswordRecoveryServiceImpl$ResetPasswordVerificationManager$Verification
run.halo.app.extension.JSONExtensionConverter$ExtraValidationValidator	JSONExtensionConverter$ExtraValidationValidator
run.halo.app.security.LoginHandlerEnhancerImpl	LoginHandlerEnhancerImpl
run.halo.app.security.CorsConfigurer	CorsConfigurer
run.halo.app.theme.message.ThemeMessageResolver	ThemeMessageResolver
run.halo.app.theme.finders.vo.ListedPostVo	ListedPostVo
run.halo.app.theme.finders.impl.PostPublicQueryServiceImpl	PostPublicQueryServiceImpl
run.halo.app.console.ProxyFilter	ProxyFilter
run.halo.app.content.comment.OwnerInfo	OwnerInfo
org.springframework.boot.loader.launch.JarFileArchive$JarArchiveEntry	JarFileArchive$JarArchiveEntry
